㠭	aaaa
㐂	aaab
菚	aaau
匞	aad
䘌	aadj
茙	aadr
蘜	aafo
䒰	aagf
䓉	aahb
菣	aahc
茝	aahh
茞	aahh
藍	aahl
藖	aahm
虦	aahw
蕥	aahy
剗	aajh
蓳	aakg
蓲	aakk
䕚	aakm
䕿	aako
䖄	aako
䕼	aaky
盞	aalf
蘳	aamf
蘣	aamg
䔈	aamu
葉	aans
苉	aaqb
蔕	aaqh
蘙	aatn
戔	aau
苆	aavr
匶	aawe
荗	aawu
蒆	aawv
莁	aaww
茿	aawy
芅	aayu
藂	abci
萾	abcl
菆	abcu
䔺	abde
蘟	aben
㲨	aben
芓	abf
䔖	abft
卭	abh
匩	abhg
䒱	abig
䕄	abil
藬	abkm
莻	abkx
䓝	ablf
䔴	abmc
䔜	abmf
㧭	abrj
蔯	absj
蕯	abtg
蓀	abti
䕖	abtp
䔹	abue
薩	abug
䔒	abuk
匜	abv
蔭	abwc
䕃	abwd
蒢	abws
蘵	abyj
䒪	acaj
匥	acak
蔘	acce
蓪	acep
㦯	acgd
䕂	ackp
葈	acks
䓿	aclf
蓩	acne
芧	acnh
蕷	acnm
鶜	acno
葇	acns
䓮	acnt
䔍	acou
荾	acwt
芆	acyu
䒎	adac
蔵	adah
苃	adcu
藞	addd
䔸	addd
䒴	adef
萇	adeu
莾	adfa
莀	adfe
䔚	adfe
荂	adfn
葴	adgk
䓐	adgn
䒠	adhj
蒧	adhk
䓏	adhk
芣	adhu
蔧	adhv
菴	adjn
蘷	adjt
鄀	adkb
蠚	adkj
匲	adkk
䖃	adkk
逽	adkp
䓴	admd
荋	admj
蕆	admu
項	admy
荿	adnb
荙	adpu
蒝	adri
䔪	adrr
䓫	adsk
䓓	adtf
藶	adth
芖	adu
䕢	adua
蕼	advg
蘛	adwe
菶	adwg
藄	adwi
萶	adwj
㥦	adwn
䔮	adwr
匧	adww
莢	adww
㰼	adww
弎	adyi
葢	adyl
芼	aeb
萉	aecb
薍	aecn
蕦	aedm
萠	aeef
蓞	aeef
荕	aeer
萲	aegc
莇	aege
巭	aegu
藇	aegw
蓃	aehc
苚	aej
薶	aejf
﨟	aejn
虋	aemv
䕟	aemw
蕣	aepg
薆	aept
萖	aeqb
葋	aeqk
蕮	aeqo
艻	aer
䔕	aesu
㣉	aet
䔄	aetb
葄	aetf
蘨	aeti
蔿	aeto
蕂	aeue
䕨	aeui
虅	aeuo
㔱	aewi
蒵	aexd
䩸	afab
韄	afac
䪇	afaf
鞾	afag
鞳	afak
䩽	afak
韊	afal
蕡	afam
靾	afan
韉	afao
鞢	afas
韈	afaw
䪄	afaw
䕙	afay
䩶	afbj
靸	afby
鞁	afby
蓋	afcl
䩻	afco
䒧	afcu
靫	afcy
䩨	afde
䩴	afde
䩬	afdg
䩭	afdk
䩡	afdw
蘎	afec
鞵	afed
鞱	afee
靻	afeg
䩗	afeg
鞖	afev
蕓	affc
茥	afff
靯	affg
靬	affh
鞊	affk
韇	affm
䩿	affm
韃	affp
蕘	affq
䓁	affu
䕀	affw
䩒	afgf
韁	afgg
䩯	afbg
䩹	afgh
靰	afgq
鞕	afgr
靺	afgs
鞆	afgw
䩟	afgw
䩘	afgx
䩫	afgy
鞐	afhh
䩞	afhk
䩤	afhq
蒖	afhw
鞺	afif
鞜	afij
鞩	afij
鞝	afik
䩖	afit
䒬	afiu
芉	afj
鞸	afjg
鞮	afjh
鞰	afjl
鞨	afjn
韅	afjo
䩰	afkb
薣	afkc
鞙	afke
䓀	afkf
鞓	afkg
蘦	afkk
虂	afkk
䕒	afkk
鞼	afkm
䕵	afko
薳	afkp
䪈	afkp
䪋	afkp
䖅	afkw
鞇	afld
䪅	aflj
匵	aflm
藚	aflm
鞻	aflv
萳	afmf
䩜	afmg
䪎	afmk
䪆	afmu
靹	afmw
貳	afmy
芌	afnb
薵	afnf
靵	afng
䩛	afnt
䓌	afnu
䩲	afoc
䪁	afog
䕋	afok
韀	afoo
䩾	afoo
䓇	afou
鞚	afpa
䩩	afpb
䩳	afpc
葧	afpe
䑓	afpf
䩵	afpl
䩪	afpn
䪀	afpn
䩕	afqb
䩓	afqc
鞉	afqi
鞄	afqn
䳬	afqo
䓕	afqp
荺	afqu
靮	afqy
韂	afqy
䩚	afqy
䪌	afqy
鞞	afrf
䩢	afrr
鞡	afru
䩝	afry
靪	afsh
䪂	afsm
韆	afsp
䒹	afsu
䓔	aftb
鞽	aftk
䩐	aftn
鞦	afto
䩠	aftp
䩥	aftp
䩼	aftp
荖	aftx
鞂	afty
苿	afu
蕔	afuc
䪊	afud
靽	afug
鞧	afug
鞛	afuk
䪍	aful
䕮	afuo
薘	afup
蓻	afuy
䩮	afvi
鞀	afvk
䪉	afvn
鞬	afvp
靭	afvy
靱	afvy
鞎	afvy
鞥	afwa
蕶	afwc
藝	afwc
䩔	afwc
䩱	afwj
薔	afwk
鞈	afwk
靲	afwn
䩺	afwn
爇	afwo
䕭	afwo
䩣	afws
蓺	afwy
鞃	afxc
靿	afxe
靷	afxh
䩑	afxn
鞿	afxw
鞟	afyb
鞹	afyb
蘾	afye
䩧	afyg
弍	afyi
䪃	afyt
䩙	afyx
䩷	afyy
華	agag
茾	agaj
荊	agaj
鷨	agao
邼	agbh
萅	agbj
芚	agbn
荎	agcf
㦶	agcf
菿	agcj
菾	agdn
藸	agej
蓫	agep
劻	aget
䔷	aggn
龷	aghg
卄	aghh
芐	aghu
莍	agiy
蓴	agjf
荁	agjg
莄	agjr
䓊	agkf
菫	agkg
蒚	agkh
蘁	agkk
葍	agkl
䕱	agkm
虉	agko
荳	agku
薑	aglg
䒥	agmh
蓸	agmj
蔶	agmu
苪	agmw
黃	agmw
㔷	agmw
䕻	agmx
䓣	agmy
匸	agn
䒓	agnb
䓧	abkg
㤍	agnn
䲾	agno
㚽	agnv
瓨	agny
䛒	agny
塟	agqf
茢	agqj
薚	agqr
蔜	agqt
薞	agqv
䔊	agua
莖	agva
葝	agve
萐	agvh
蕐	agwg
薾	agwr
䓯	agxu
匤	agyi
弌	agyi
萛	ahaj
韮	ahdg
薉	ahdh
繤	ahdi
㔈	ahdj
蕜	ahdn
䕁	ahds
蔖	aheg
䒙	ahf
蕋	ahhh
蘋	ahhm
荹	ahhr
蘃	ahhs
匷	ahhy
茮	ahiu
䓬	ahjj
賾	ahkm
頤	ahkm
巸	ahkn
媐	ahkv
㼢	ahky
蘆	ahll
藘	ahln
蓾	ahlo
孯	ahnb
䢻	ahnb
臤	ahnc
硻	ahnd
腎	ahne
㲯	ahne
堅	ahnf
朢	ahng
㹂	ahng
䑑	ahng
䁂	ahnh
緊	ahni
䑐	ahni
䵖	ahni
蜸	ahnj
㔋	ahnj
臨	ahnk
監	ahnl
盬	ahnl
鹽	ahnl
賢	ahnm
贒	ahnm
頣	ahnm
薡	ahnn
煕	ahno
㷂	ahno
覧	ahnq
覽	ahnq
鋻	ahnq
鍳	ahnq
鑒	ahnq
掔	ahnr
擥	ahnr
㯺	ahns
竪	ahnu
豎	ahnu
䜿	ahnu
䝂	ahnu
婜	ahnv
䭆	ahnv
臥	ahnw
䖙	ahnw
譼	ahny
㻨	ahny
㽉	ahny
䛗	ahny
蔝	ahou
莧	ahqb
薒	ahqo
萈	ahqy
䪵	ahtm
鴉	ahto
㸧	ahtv
萀	ahwb
藈	ahwd
䔝	ahxi
䓱	ahxs
㸦	ahyi
䔐	aiaa
蘫	aial
菃	aian
葓	aiaw
蔢	aibv
菭	aick
莦	aief
萷	aiej
蔆	aift
䓑	aiga
蔳	aige
茪	aigq
蔋	aihc
䓾	aiiv
䕕	aijc
䓠	aijf
蕰	aijl
蘯	aijl
䔽	aijn
蕩	aijr
蕅	aijy
䕪	ailf
薀	aill
莐	aipq
䓋	aiqa
萢	aiqn
䓜	aiqy
萡	airf
䓅	airj
薸	aisi
藫	aisj
莯	aisu
萿	aitd
䒚	aitr
䓷	aits
虌	aitx
䒕	aiu
蓱	aiua
蓡	aivc
薓	aivc
葏	aivg
菬	aivk
蒅	aivs
薻	aivs
莈	aiwc
虃	aiwg
蕍	aiwj
蒤	aiws
蒞	aiwu
匯	aiwy
蓅	aiyk
薃	aiyk
蓽	ajag
皵	ajby
鄚	ajdb
蟇	ajdj
驀	ajdo
㱳	ajdq
謩	ajdy
䒤	ajf
荲	ajff
蒔	ajff
䓍	ajfj
䕎	ajgl
㓚	ajh
萺	ajhf
剒	ajjh
蕌	ajjj
蒀	ajlf
勱	ajme
躉	ajmh
蠆	ajmj
䘍	ajmj
䖁	ajmn
邁	ajmp
萬	ajmy
䒶	ajnt
逪	ajpd
鵲	ajqo
䓪	ajqr
斮	ajrh
茰	ajru
菒	ajsu
菓	ajsu
葃	ajtf
虄	ajtg
㪚	ajty
匽	ajvd
鶠	ajvo
㰽	ajvw
䧿	ajwy
菎	ajxx
䓃	akcb
戓	akd
莂	akej
菋	akfu
尀	akfy
䰥	akgc
戜	akgd
茣	akgd
㳼	akgi
囏	akgk
懃	akgn
戁	akgn
㸐	akgo
覲	akgq
彧	akgr
斳	akgr
㝻	akgt
㠬	akgu
艱	akgv
歎	akgw
歏	akgw
臡	akgw
㰲	akgw
㔮	akgx
難	akgy
䕽	akhj
蕗	akhk
匱	akhm
蕢	akhm
莡	akhu
鄿	akkb
酄	akkb
䕤	akkb
敺	akkc
毆	akkc
勸	akke
匰	akkf
蕇	akkf
剾	akkj
飌	akkj
區	akkk
虈	akkk
䓵	akkk
䖀	akkk
顴	akkm
蕚	akkn
鷗	akko
鸛	akko
觀	akkq
蘄	akkr
䕾	akkt
歐	akkw
歡	akkw
甌	akky
雚	akky
蒷	akmu
酀	akub
㬫	akuj
鷰	akuo
㷼	akuo
䴏	akuo
嬊	akuv
荶	akwn
蓶	akwy
蔮	alag
㔴	alaw
䔬	alaw
蘻	albi
藣	alcx
䓢	aldf
蘮	aldj
莮	aler
薗	alfe
䕉	alff
蓒	alfj
䕸	alfk
葨	alge
莗	alj
蘲	allf
虆	alli
藟	alll
蘽	alls
蕒	almu
薎	alpa
鄸	alpb
蘉	alpc
䒐	alpc
䠢	alph
顭	alpm
夢	alpq
蓮	alpu
薥	alqj
鶓	alqo
蔪	alrj
蔨	alub
蔞	alvf
藪	alvt
匭	alvv
蒕	alwl
莔	alwm
苬	alwu
蔂	alxi
蘿	alxy
藅	alyj
蕽	amae
䒼	amaf
䓦	amaw
䣐	amdb
㲟	amde
鶧	amdo
䚆	amdq
蘴	amdu
蓇	amef
䕧	amer
苖	amf
冓	amff
斠	amff
䒣	amff
䓟	amfk
顜	amfm
覯	amfq
䔇	amgu
繭	amhj
芇	amhj
顢	amhm
㒼	amhy
荝	amjj
萴	amjj
蘡	ammv
䒻	amnb
萵	amnk
薖	amnp
慐	amnu
䒽	amrr
貢	amu
菵	amun
䵍	amwb
䵋	amwe
䵏	amwe
斢	amwf
黊	amwf
䵐	amwf
黈	amwg
䵎	amwj
黇	amwk
黅	amwn
鷬	amwo
黆	amwq
䵌	amww
萞	amwx
䒟	amyf
䢹	anbh
䓛	anbm
荱	aneb
苢	anf
㓸	anfj
䒖	anfj
藯	anfn
斲	anfr
䒭	anfu
䒒	angf
葿	anhf
䔫	anhm
蕸	anhp
荍	anht
螶	anjj
葦	ankg
蘗	anks
勚	anme
勩	anme
貰	anmu
乬	annb
巪	annb
蘂	anns
㔵	annw
迣	anpv
㰥	anqw
䢡	ansp
枼	ansu
苾	antr
戉	anv
芵	anwu
藋	anwy
苨	anxb
蘹	anye
䕜	anyf
蓆	aoah
薠	aodm
蘱	aodm
蓭	aodn
蕿	aoec
薦	aogo
蔊	aojf
䑞	aoog
藀	aooo
菼	aoou
蒾	aopu
菧	aoqy
䓎	aoqy
䕇	aorc
䕷	aosi
藦	aosr
蔴	aoss
䕰	aotl
炗	aou
苂	aou
䕺	aouc
薱	aouf
薕	aouw
蓎	aovk
菮	aovw
䕠	aowc
蓙	aowf
薼	aoxf
藨	aoxo
蘪	aoxo
蔍	aoxx
䕲	aoyi
藆	apar
茡	apbf
藔	apdi
藼	apdn
䒿	apef
萓	apeg
藛	apeo
氋	apfe
蒄	apff
鹲	apfg
萗	apfi
鸏	apfo
蔲	apft
䓻	apfv
荢	apgf
萣	apgh
䔰	apgl
薲	apgm
蔩	apgw
蓂	apju
葷	aplj
䔭	apne
藌	apnj
蔤	apnm
薴	apns
䒞	apqb
蒬	apqy
蒏	apsg
苧	apsj
䓨	aptb
䔂	apuj
䕣	apun
荌	apvf
䒯	apvy
葖	apwd
䓖	apwe
䕓	apwi
茓	apwu
藭	apwx
蒮	apwy
䒮	apwy
䔃	apyg
䕐	apyl
䔗	apyu
䣟	aqab
鬵	aqah
朁	aqaj
蠶	aqaj
㔆	aqaj
䫬	aqam
兓	aqaq
茋	aqay
茒	aqbj
䒢	aqbj
葾	aqbn
蒭	aqbt
芶	aqcu
䔳	aqdo
薝	aqdy
蔛	aqef
薢	aqeg
葪	aqej
菳	aqf
荈	aqgj
蔔	aqgl
㔰	aqhi
㢣	aqka
葂	aqke
蟼	aqkj
憼	aqkn
驚	aqko
莬	aqkq
䓒	aqlf
藑	aqmt
萯	aqmu
㤅	aqnu
薊	aqoj
蘇	aqot
炁	aqou
蔦	aqou
蘚	aqou
䔡	aqou
䲨	aqoy
帶	aqph
䠠	aqph
慸	aqpn
遰	aqpp
鴄	aqqo
茤	aqqu
䔙	aqqy
匢	aqre
匫	aqrj
䓤	aqrn
茐	aqry
䔆	aqtf
莥	aqtg
蕕	aqtg
蕏	aqtj
䓄	aqtr
芕	aqu
兂	aqv
旡	aqv
蕵	aqwv
匛	aqyi
藰	aqyj
蒥	aqyl
芞	arb
葼	arbt
萚	arcg
苽	arcy
蓏	arcy
莃	ardh
䔤	ardj
蘤	areo
苩	arf
茊	arf
葟	argf
蓵	argh
茩	argk
荴	argu
䕫	arht
㔸	arhw
薬	aris
莏	arit
葲	ariu
䔶	arjh
苅	arjj
䔾	arjn
䔱	arkb
蘀	arlf
菗	armf
菦	arpu
蒐	arqc
菢	arqn
鴎	arqo
鴱	arqo
菂	arqy
䓆	arrj
藠	arrr
䒝	arru
蔱	arsc
䔌	ardf
䓭	arsj
蒱	arsu
葀	artd
菈	aruf
蒑	arvc
萔	arvk
蓷	arwy
藥	arxs
薂	aryt
藲	asak
䕩	asdi
䓩	asfc
荰	asff
蓕	asff
䓰	asff
蔈	asfi
蒪	asfu
薽	asfy
䕯	asfy
䔯	asgd
䖆	asge
莤	asgf
蓜	asgn
䔠	asie
艼	asj
菄	asjf
莕	askf
䓶	askj
䔅	askk
藾	askm
藗	askp
䔎	askp
䔩	askt
萰	aslf
茦	asmb
莿	asmj
蕀	asmm
蓛	asmt
萙	aspq
菻	assu
䔁	assu
䖇	aste
䔦	astx
㭉	asu
葽	asvf
䕆	aswj
藮	aswo
萊	asww
蒁	asyp
殹	atdc
䃜	atdd
㬾	atde
㙠	atdf
䒷	atdf
醫	atdg
鹥	atdg
瞖	atdh
莑	atdh
繄	atdi
䗟	atdj
蕎	atdk
㗨	atdk
䓡	atdk
贀	atdm
悘	atdn
鷖	atdo
黳	atdo
芺	atdu
䒨	atdu
嫛	atdv
毉	atdw
瑿	atdy
薙	atdy
䕝	atef
蒩	ateg
䓚	ateg
䔘	atfg
蓗	atfh
䔏	atfp
薐	atft
蒛	atfw
䓙	atfx
蘍	atge
苼	atgf
菙	atfa
䒜	atgj
蕪	atgo
薫	atgo
苵	atgu
匴	atha
葮	athc
苲	athf
䕗	athj
䓘	athk
蒠	athn
莚	athp
蕱	atie
葕	atis
萫	atjf
䔣	atjg
藒	atjn
䔧	atjs
㦴	atkd
茖	atkf
萂	atkf
莵	atky
萭	atky
䒸	atlf
蔥	atln
薁	atmd
藢	atmt
䒗	atnb
蒒	atnh
蘬	atnh
躠	atnh
糵	atno
㔑	atnv
㜸	atnv
萩	atou
䒦	atpu
蘒	atqn
蘓	atqo
䔟	atqq
蔾	atqs
䕔	atqs
菞	atqt
薭	atrf
蓹	attb
蘌	atti
蕧	attt
䔉	attu
蘒	attx
䒘	atu
䒩	atu
蒰	atuc
苸	atuf
萪	atuf
蕛	atut
苳	atuu
蘶	atvc
葎	atvg
䓳	atvu
萟	atvy
䓈	atwc
蓯	atwh
蘈	atwm
䕴	atwo
蒣	atws
䕌	atwy
藊	atya
蒫	auaf
荓	auaj
䕈	auas
蓘	auce
萒	aucq
藙	auec
蘢	aued
蕑	auef
葥	auej
苙	auf
菛	auf
匨	aufd
荘	auff
莊	auff
蘠	aufk
蓤	auft
菤	augb
䓺	augd
蓔	augo
葁	augv
䕏	augy
萻	aujf
蕫	aujf
蕳	aujf
蔁	aujj
㔶	aujm
䔔	aujq
蔀	aukb
蔉	auke
蔄	aukf
䕡	aukk
莌	aukq
蕄	aunu
蔣	auqf
蒟	auqk
薋	auqm
藱	aurc
䔿	ausf
蘭	ausl
藽	ausq
䔵	ausu
虁	autt
菨	auvf
蔅	auvf
藺	auwy
苝	auxb
䕞	auyv
蕁	avaf
蔇	avaq
䒵	avbf
莭	avbj
䓼	avdy
䕅	avec
蕭	avfj
茟	avgj
葘	avgl
藎	avhl
菉	aviu
蕠	avki
蒘	avkr
菑	avlf
䔥	avoj
菷	avph
芀	avr
㓛	avt
䒲	avta
莙	avtk
蔒	avto
芛	avtr
䓸	avvf
茘	avvv
葌	avvv
袃	avye
䔼	avyh
荵	avyn
茷	awau
䒫	away
芁	awb
䢼	awbh
芿	awbr
㗡	awbx
䓗	awcn
葰	awct
芢	awff
菕	awga
葊	awga
蘥	awga
蒨	awge
䔑	awgf
剳	awgj
匬	awgj
萮	awgj
薈	awgj
匼	awgk
荅	awgk
鷋	awgo
蘞	awgt
巬	awgu
䔲	awgu
匳	awgw
薟	awgw
蘝	awgw
蓚	awhe
蓨	awhe
蓧	awhs
苶	awiu
㳟	awiu
蛬	awju
䢽	awkc
㔯	awkd
藵	awke
茽	awkh
輂	awlj
苮	awmj
葔	awnd
䳍	awqo
拲	awrj
茠	awsu
㭟	awsu
䒳	awsu
莋	awtf
葻	awtj
䔀	awtv
䒔	awu
䓲	awuq
葠	awvc
葐	awvl
棻	awvs
㔲	awvv
㔳	awvw
莝	awwf
葅	awwg
鹀	awwg
䔢	awwn
鵐	awwo
遳	awwp
覡	awwq
䕥	awwr
蓌	awwt
芲	awxb
蕟	awxc
蒊	awxx
聓	awyb
蒦	awyc
䂬	awyd
舊	awye
鞏	awyf
㠫	awyg
莟	awyk
蒼	awyk
䡗	awyl
䕘	awym
菍	awyn
䊄	awyo
㧬	awyr
䅃	awyt
芃	awyu
䓹	awyv
㼦	awyy
葒	axaf
虇	axay
葞	axbf
苰	axcu
䔛	axdm
藧	axec
苭	axer
蒃	axeu
䕑	axev
蘏	axfm
葤	axfu
䕬	axgg
蒓	axgn
䕳	axgr
䒡	axhj
苐	axht
䔋	axit
䒺	axiu
蘰	axjc
茀	axjj
藴	axjl
蔃	axkj
蘊	axll
蒳	axmw
䒛	axnb
蕝	axqc
葯	axqy
薌	axtb
薿	axth
蘔	axtm
蘕	axtp
蔠	axtu
䔨	axty
苺	axu
蒻	axuu
蒶	axwv
蕬	axxi
茲	axxu
䔻	aybt
䕛	aydw
蘐	ayec
䕍	ayek
䒾	ayeu
䕦	ayey
䓂	ayf
藷	ayfj
虀	ayhg
萕	ayjf
薺	ayjf
藹	ayjn
蘘	ayke
䕊	aylg
藳	aymt
貣	aymu
藃	aymw
萹	ayna
䓽	aynb
蔰	aync
䓞	aynd
菺	ayne
莣	aynn
荄	aynw
㼹	ayny
薧	aypx
鳶	ayqo
蘺	ayry
葹	aytb
䔓	aytf
蔙	ayth
蒍	ayto
芠	ayu
蔐	ayud
蔏	ayuk
藡	ayup
蓈	ayvb
蓢	ayve
苀	aywb
蔎	aywc
䕶	aywc
匟	aywv
䬥	aywv
隿	aywy
䕹	aywy
䔞	ayxf
䖂	ayxr
虊	ayxs
䧖	baay
陿	badw
隁	bajv
聝	bakg
䧕	bakg
䧢	bakk
䧆	bawy
聀	bay
孨	bbbf
聶	bbbf
孴	bbbj
顳	bbbm
㱌	bbbw
孖	bbg
聑	bbg
䦻	bbg
䧝	bbhj
聉	bbmh
阤	bbn
郰	bcbh
埾	bcff
夃	bci
㔌	bcij
孡	bckg
㿬	bcn
㜿	bcnh
䦽	bcnh
焣	bcou
㷅	bcou
䧞	bcoy
阭	bcqn
棸	bcsu
陖	bcwt
隓	bdaa
墮	bdaf
嶞	bdam
隨	bdap
䢫	bdap
㯐	bdas
䜐	bday
阨	bdbn
耾	bdcy
䧀	bdcy
陏	bdeg
呄	bdf
陙	bdfe
陓	bdfn
隇	bdgv
阫	bdhy
陾	bdmd
㿵	bdmd
聏	bdmj
陑	bdmj
頗	bdmy
陭	bdsk
陦	bdtf
陝	bdty
聗	bdww
陜	bdww
隉	beag
隱	bean
檃	beas
櫽	beas
䧟	beeg
䎳	beg
䏂	behc
毦	ben
聣	beqn
阞	bet
䧦	beto
䧌	bevg
隠	bevn
隫	bfam
耺	bfcy
阹	bfcy
隭	bfdj
隢	bffq
皯	bfh
䦹	bfh
䎴	bfjh
聐	bfkg
㝆	bfkk
聴	bfln
隯	bfnf
陼	bftj
㿹	bfup
陸	bfwf
陚	bgay
孒	bgd
聙	bgeg
孲	bgfg
聽	bgfn
聇	bghg
阷	bghg
䧠	bgjf
䧥	bgjn
䎸	bgkg
䏆	bgmj
陃	bgmw
隞	bgqt
㭆	bgsu
陘	bgva
隬	bgwr
䧅	bgxw
芔	bhbh
陫	bhdd
阯	bhg
隵	bhga
㞢	bhgd
㞷	bhgf
旹	bhgj
妛	bhgv
騭	bhho
䧋	bhqn
䖎	bhwn
㞣	bhwv
顄	bibm
陗	bieg
脀	bige
巹	bign
烝	bigo
氶	bii
㞼	bimj
隚	bipf
隲	bito
阥	biy
䧉	bjfg
隄	bjgh
陽	bjgr
刵	bjh
㓟	bjh
䎶	bjhh
㿸	bjlc
䏉	bjxo
凾	bkcb
焏	bkco
䧎	bkeg
叾	bkf
聖	bkgf
䦿	bkhh
聵	bkhm
隤	bkhm
隕	bkmy
盁	blf
塦	blff
䧃	blg
陣	blh
䢺	bmbh
䪼	bmdm
㔘	bmet
耼	bmfg
䎻	bmfk
䧓	bmfk
㞊	bmfn
䄐	bmfn
䳳	bmfo
㱁	bmfw
隑	bmgu
䖓	bmhw
孾	bmmv
糶	bmoy
欪	bmqw
䧙	bmwn
孭	bmy
䧩	bnbt
阠	bnfh
隦	bnku
巜	bnn
耴	bnn
⺋	bnn
㔾	bnn
䎲	bnn
䎵	bntt
孞	bnu
䦼	bnwy
恥	bny
䧪	bodv
㷦	boou
隣	boqg
䧨	bouf
䧤	boug
䧡	bovh
䧜	bovk
阦	boy
褧	boye
䢊	bpd
䧮	bpdn
辸	bpe
孮	bpfi
聢	bpgh
䧑	bpgh
䧬	bpgm
䏃	bpju
皹	bplh
聹	bpns
䏁	bpuh
迆	bpv
聜	bpwa
䏄	bpwf
聺	bpwi
䎽	bqaj
阺	bqay
陒	bqdb
聸	bqdy
陥	bqhj
聎	bqiy
䧁	bqkg
㝃	bqkq
䧯	bqky
﨩	bqmh
皰	bqnn
䧰	bqoi
陱	bqoy
隖	bqoy
隝	bqoy
鵈	bqoy
㚉	bqqu
陊	bqqy
聦	bqrn
聭	brqc
㝂	brrh
聛	brtf
陻	bsfg
䏇	bsfi
䧣	bsfi
䧈	bsg
䦺	bsh
陳	bsjg
刴	bsjh
螴	bsjj
敶	bsjt
䏀	bskj
娿	bskv
朶	bsu
䧒	bsww
陠	bsy
陞	btaf
阩	btah
陹	btaj
艸	btbh
茻	btbh
陁	btbn
㪿	btbr
䧏	btdh
聅	btdy
聕	btfk
䧊	btfk
陎	btfy
䎷	btfy
䃧	btgd
隀	btgf
䎺	btgj
䧗	btjt
䧄	btkg
聥	btky
聰	btln
䧭	btln
隩	btmd
阣	btnn
㤵	btnu
䎿	btoy
孼	bttb
蠥	bttj
糱	btto
櫱	btts
辥	bttu
雟	btwk
孫	btxi
愻	btxn
遜	btxp
聠	buah
隴	bued
䏊	bued
墜	buef
鐆	bueq
隊	buey
阧	bufh
䧧	bugy
隌	bujg
隡	butg
隒	buvw
孻	bvhl
䎼	bviy
隟	bvjs
䧂	bvkg
㿳	bvlg
㿪	bvyy
聡	bwcn
聬	bwcn
隂	bwdy
聄	bwet
際	bwfi
䏅	bwfi
陯	bwga
䎾	bwga
聧	bwgd
隃	bwgj
隥	bwgu
険	bwgw
險	bwgw
㜾	bwjh
㔎	bttv
聁	bwvt
䧍	bwwk
阾	bwyc
陰	bwyc
陮	bwyg
耹	bwyn
䧔	bwyn
墬	bxef
聈	bxet
䧘	bxey
乸	bxi
聨	bxxa
聫	bxxd
聯	bxxg
䏈	bxxi
阰	bxxn
聮	bxxo
階	bxxr
䧐	bybg
䧇	byey
埅	byff
卪	byi
隮	byjg
䧚	bymk
阸	bynn
㤂	bynu
䧫	bype
聤	byps
䲯	byqo
職	byuj
䧛	byuy
阬	bywn
﨤	byp
﨤	bypi
䪻	cadm
㹑	cafy
㹏	cakg
鴘	caqo
犕	cate
牫	cay
牠	cbn
叕	cccc
敠	cccc
叄	cccd
參	ccce
毲	ccce
毿	ccce
犙	ccce
㲲	llle
亝	cccf
絫	ccci
㕘	ccci
剟	cccj
剼	cccj
顙	cccm
䫎	cccm
䫩	cccm
叅	cccn
鵽	ccco
䴑	lllo
逫	cccp
遪	cccp
㓄	cccq
㕖	cccs
敪	ccct
厽	cccu
叒	cccu
欼	cccw
歠	cccw
㯩	cccw
㸭	ccn
斚	ccpf
㸻	cctd
㕕	ccu
㕛	ccu
厸	ccy
犡	cday
㹛	cdht
奙	cdjn
軬	cdlj
貵	cdmu
牻	cdny
㹉	cdri
㦷	ceay
勈	ceet
䏍	cef
䏻	cefc
㷱	cefo
㸹	cefy
㼧	cegy
㪌	cehc
䳌	ceqo
牞	cet
螚	cexj
䘅	cexj
態	cexn
熋	cexo
㹘	cfdj
頚	cfdm
㹓	cffq
㸩	cfh
犆	cfhg
㸵	cfkg
犢	cflm
㹗	cfnf
㹀	cfpb
㸿	cfpw
䯅	cgbc
骉	cgcg
骦	cgfh
驲	cgjg
䯄	cgkw
骃	cgld
㹔	cglg
㸬	cgmh
骔	cgpi
䯃	cgpv
骍	cguh
牼	cgva
骎	cgvc
骕	cgvw
骙	cgwd
犑	chdy
覌	chqn
厼	ciu
犦	cjai
㹇	cjqn
㣍	cket
瓵	ckgy
㸪	ckh
刣	ckjh
乨	cknn
㰧	ckqw
䢄	ckus
枲	cksu
辝	ckuh
巼	ckxb
犤	clcx
㸶	cldy
牭	clg
圅	cluf
㹄	clwt
㹎	clxi
牰	cmg
岊	cmj
貟	cmu
贠	cmu
犅	cmum
㸽	cmy
犌	cnhc
矝	cnhc
矡	cnhc
奦	cnhd
䂉	cnhd
務	cnhe
氄	cnhe
矟	cnhe
䂊	cnhe
堥	cnhf
鞪	cnhf
䂌	cnhf
䂇	cnhg
㐨	cnhh
㡔	cnhh
㸨	cnhh
䂍	cnhi
䋷	cnhi
劀	cnhj
暓	cnhj
矠	cnhj
䂈	cnhj
䖥	cnhj
矞	cnhk
嵍	cnhm
預	cnhm
䂎	cnhm
愗	cnhn
㥤	cnhn
熃	cnho
騖	cnho
鶔	cnho
鶩	cnho
鷸	cnho
䱯	cnho
䳱	cnho
遹	cnhp
䥐	cnhq
楘	cnhs
㮗	cnhs
敄	cnht
䜼	cnhu
㜈	cnhv
䂆	cnhy
䨁	cnhy
龴	cny
駴	coaa
駥	coad
䮬	coad
騹	coag
驊	coag
䮙	coag
馵	coaj
騲	coaj
驅	coak
駏	coan
䮅	coan
驠	coao
驧	coao
駆	coar
䮜	coas
䮲	coaw
驩	coay
䯀	cobb
䮛	cobf
駬	cobg
䣕	cobh
驟	cobi
馳	cobn
馺	coby
駊	coby
䮁	coca
䮕	cocc
騃	cocd
驂	coce
騒	cocj
騷	cocj
駘	cock
驈	cock
騳	coco
驫	coco
馻	cocq
騥	cocs
䮣	cocs
䯂	cocs
駿	coct
馭	cocy
騞	codd
䮆	codf
駓	codg
騵	codi
䮞	codj
騎	codk
騻	codr
騏	codw
馱	cody
駀	cody
駄	cody
駹	cody
䭾	cody
䮂	cody
騪	coec
騱	coed
䮑	coef
駔	coeg
䭷	coen
䮘	coeq
䮭	coeq
馶	cofc
䮃	cofc
䮻	coff
驖	cofg
馯	cofh
驦	cofh
䭴	cofj
䭼	cofj
驍	cofq
驝	cofs
䮚	coft
駍	cogf
駤	cogf
馷	cogh
䮥	cogh
䭶	cogj
䮋	cogj
䮏	cogk
驑	cogl
䮠	cogl
駵	cogn
䮱	cogp
䮯	cogt
䮊	cogw
驪	cogx
騑	cohd
䮹	cohh
䮓	cohj
驢	cohl
驉	coho
馬	coi
騨	coif
駫	coiq
駻	cojf
馹	cojg
驆	cojg
騠	cojh
䮖	cojj
騔	cojn
騍	cojs
騴	cojv
騉	cojx
䣖	cokc
駽	coke
驒	cokf
馴	cokh
馽	cokh
駛	cokr
駰	cold
驛	colf
駟	colg
騾	coli
䮷	colj
騦	coln
䮫	colv
駚	comd
䮩	come
䮗	comf
駎	comg
駉	comk
駧	comk
騆	comk
騧	comk
驨	comk
䮐	comk
騁	comn
驏	conb
騢	conc
騛	conh
駶	conk
騽	conr
駜	cont
駃	conw
駅	cony
驜	coof
驎	coog
䮼	coog
㹙	cooh
㹚	cook
䮽	cooo
騼	coox
䮟	copc
䮿	coph
遤	copi
騌	copi
䮝	copl
驞	copm
馾	copq
䮨	copu
駝	copx
䮤	copy
駠	coqb
騊	coqb
䭹	coqb
駣	coqi
駨	coqj
駒	coqk
騮	coql
騘	coqn
䮀	coqn
䮈	coqq
䮪	coqs
騶	coqt
馰	coqy
騩	corc
駈	corg
騜	corg
馸	corh
䮎	corh
騡	cori
駁	corr
騣	cort
驃	cosi
驔	cosj
駷	cosk
䮮	cosq
騕	cosv
騋	cosw
䮒	cosy
馲	cota
駞	cotb
䮉	cote
䮢	cote
駯	cotf
騈	cotf
䮔	cota
䭽	cotg
䭿	cotg
駱	cotk
驕	cotk
䮳	cotl
驄	cotn
駳	cotp
駪	cotq
䮡	cott
騬	cotx
駇	coty
騀	coty
駢	coua
䮾	coud
䮵	couf
㹒	coug
騂	couh
騚	couj
騿	couj
驓	couj
驣	couo
駾	couq
駮	cour
驥	couw
駸	covc
䮇	covg
騄	covi
驌	covj
駋	covk
騝	covp
駖	cowc
驋	cowc
騤	cowd
駗	cowe
駙	cowf
駩	cowg
颿	cowj
騟	cowj
騇	cowk
騐	cown
䭸	cowr
駼	cows
䮌	cows
䮶	cows
䮴	cowu
䭻	cowv
験	coww
驗	coww
騅	cowy
䭵	cowy
犥	coxo
騙	coya
䮰	coyd
驤	coye
䮍	coye
駐	coyg
驙	coyg
駲	coyh
䮺	coyj
䮦	coyk
馿	coyn
騸	coyn
驐	coyt
駺	coyv
駭	coyw
䭺	coyw
䮄	coyx
馼	coyy
騯	coyy
䯁	coyy
牸	cpbg
犗	cpdk
㹆	cplh
㹊	cpwy
㸰	cpxn
牴	cqay
犓	cqbt
觕	cqeh
鳮	cqoy
惣	cqrn
㹅	cqrn
㸸	crgk
㸫	crh
犔	croy
牱	cskg
㸱	ctbn
㸼	ctdh
犞	ctdk
逘	ctdp
欸	ctdw
劺	ctge
牜	ctgg
牪	ctgh
鴾	ctgo
㸲	cthf
牬	ctnt
犐	ctuf
㸯	cufh
犈	cugb
㹖	cuge
犠	cugy
犧	cugy
䍧	cuh
㕚	cui
犝	cujf
犃	cukg
㹌	cutg
犪	cutt
犣	cvln
㸾	cvyn
牣	cvyy
牷	cwgg
㹋	cwhe
鵕	cwto
夋	cwtu
㕙	cwty
㸮	cwvt
㸳	cwyc
牳	cxy
犉	cybg
犜	cybt
㹁	cyiy
牤	cynn
牥	cyt
㹍	cyud
牨	cywn
礷	daal
碊	daay
毻	daee
䃊	daeg
遀	daep
䃟	daet
礚	dafl
矼	dag
䃘	dahf
礛	dahl
礥	dahm
厊	daht
㚏	daj
勵	daje
碏	dajg
礍	dajn
厲	dajy
厪	dakg
㚜	dakg
䂸	dakg
奩	dakk
礶	daky
礣	dalw
碤	damd
䃓	damf
碽	damy
䂵	damy
奆	danf
䃡	daqj
礡	dasf
硴	dawx
硔	dawy
䂝	day
㿴	dbby
頋	dbdm
矷	dbg
㕔	dbgn
䂙	dbh
㚎	dbj
砐	dbyy
硁	dcag
夿	dcb
磣	dcce
硧	dceh
䀾	dchf
唘	dckf
翃	dcng
䂛	dcnh
礟	dcor
礮	dcor
碼	dcoy
厷	dcu
厺	dcu
㕝	dcu
䫺	dcwj
犮	dcyi
盋	dcyl
䳊	dcyo
䂘	dcyy
䦈	ddag
礪	dday
砈	ddbn
㕆	ddd
飆	dddj
㔏	dddj
猋	dddu
䂻	ddey
磭	ddfe
砳	ddg
䃭	ddgn
碶	ddhd
䂜	ddhh
磩	ddhi
奭	ddjj
硽	ddjn
奤	ddlf
黡	ddlo
碝	ddmd
碩	ddmy
厖	ddny
硥	ddny
䃎	ddqq
磢	ddrr
碕	ddsk
礰	ddth
㚐	ddu
镽	ddui
磡	ddwe
碪	ddwn
硤	ddww
䃆	ddwy
厐	ddxy
夶	ddy
㹜	ddy
鬕	dead
䯷	dead
䰒	deae
戫	deag
䰐	deal
髰	dean
㦽	deav
髸	deaw
鬗	deay
髢	debb
髶	debf
䯮	debr
髲	debu
䯲	decb
鬖	dece
䰆	decs
髳	dect
䯭	decu
髪	dedc
鬌	dede
鬍	dede
髬	dedg
䯱	dedh
髵	dedj
鬊	dedj
䰅	dedm
髮	dedy
鬅	deee
奟	deef
䯶	deeg
鬚	deem
䰂	dees
䯵	defa
鬐	defj
䰇	defj
䰑	defj
髨	defq
鬒	defw
䰏	defy
㚗	degf
砠	degg
髩	degn
礖	degw
砽	deh
䰕	dehl
髾	deie
髿	deit
䯯	deit
鬘	dejc
鬄	dejr
䰋	dejv
䰎	dekm
䀁	delf
鬛	deln
䰄	deln
髷	dema
鬞	deme
髥	demf
䯾	demk
㤫	denu
戞	depa
鄾	depb
迶	depd
鬢	depm
㥑	depn
髧	depq
鬡	deps
憂	dept
㱊	depw
鬇	deqh
䯺	deqk
髱	deqn
磶	deqo
鶘	deqo
鶦	deqo
㕐	deqo
䯼	deqo
䳑	deqo
鬉	dert
鬂	derw
鬆	desc
䰊	desf
䰍	desi
鬎	desj
髤	desu
劯	det
磘	detb
䰉	detc
髺	detd
髼	deth
䰌	deth
鬁	detj
䯻	detk
䰔	detl
䰖	detm
䃣	deto
鬔	detp
㬼	dett
䰀	detv
䰓	dety
長	deu
䰈	deua
龓	deud
鬜	deue
䭮	deuh
鬋	deuj
鬙	deuj
鬝	deuj
䯽	deuk
䰃	deuo
鬀	deut
鬑	deuw
䯸	deuw
䯹	devc
䰁	devi
髠	dewb
䯳	dewc
䯴	dewc
髽	dewf
鬠	dewj
䯰	dewj
䭌	dewv
磎	dexd
髴	dexj
鬤	deye
䯿	deyf
髣	deyr
䃻	dfae
䃱	dfag
逩	dfap
䂶	dfce
㕎	dfcl
夽	dfcu
圧	dfd
礝	dfdj
㦺	dfea
鄏	dfeb
䣅	dfeb
㲀	dfec
脣	dfee
㫳	dfej
䢈	dfej
䫃	dfem
敐	dfet
㰮	dfew
圶	dff
夳	dff
厓	dffd
㥣	dffn
磽	dffq
厧	dfhw
磌	dfhw
夲	dfj
厈	dfk
㕑	dfkf
硈	dfkg
礂	dfkk
礌	dflg
郀	dfnb
綔	dfni
鴮	dfno
㰭	dfnw
硳	dfoy
礵	dfsh
硣	dftb
奲	dftf
䃝	dftt
硓	dftx
䃮	dfup
碐	dfwt
礭	dfwy
硦	dgah
㓫	dgaj
㕃	dgak
䊙	dgao
揅	dgar
碔	dgay
厔	dgcf
䂋	dgcs
硏	dgdf
碃	dgeg
硺	dgey
㻹	dgey
䃁	dgfg
㻎	dggd
镸	dghy
磚	dgjf
䶠	dgkb
觱	dgke
㕏	dgkf
䃒	dgkh
䌠	dgki
顑	dgkm
䫲	dgkm
㰹	dgkw
磧	dgmy
瓳	dgny
瓺	dgny
砙	dgny
烕	dgoi
䢕	dgpd
矹	dgqn
厫	dgqt
磝	dgqt
䦋	dgqt
㭐	dgsu
砞	dgsy
丆	dgt
𠂇	dgt
硜	dgva
䃀	dgvv
镾	dgwr
㕄	dgxi
砆	dgy
砡	dgyy
厞	dhdd
奯	dhdh
剨	dhdj
奡	dhdj
熭	dhdo
奀	dhdu
㔻	dhfj
砋	dhg
䪹	dhgm
䲹	dhgo
㪺	dhhf
覔	dhhq
夒	dhht
㗤	dhik
顣	dhim
慼	dhin
㞝	dhin
䦊	dhiy
㫘	dhjf
䂽	dhjh
䫊	dhkm
盃	dhlf
磠	dhlo
硵	dhlr
碵	dhmy
㶨	dhou
㶪	dhou
硯	dhqn
鴀	dhqo
兏	dhqv
嫑	dhsv
齧	dhvb
䂮	dhvd
觢	dhve
㸷	dhvg
洯	dhvi
絜	dhvi
蛪	dhvj
㓶	dhvj
㗉	dhvk
䫔	dhvm
䚉	dhvq
栔	dhvs
㓞	dhvt
㛃	dhvv
㼤	dhvy
䛚	dhvy
䬩	dhwv
䂣	dhxn
硄	digq
奫	dijg
䂿	dijg
厰	dimt
礑	dipl
礃	dipr
夵	diu
砅	diy
皕	djdj
魘	djec
厭	djed
壓	djef
奛	djef
靨	djef
㱘	djeh
厴	djel
懕	djen
黶	djeo
擪	djer
檿	djes
㣏	djet
嬮	djev
饜	djev
䣑	djfb
㕌	djgf
碮	djgh
碭	djgr
㼣	djgy
矵	djh
夰	djj
㓦	djjh
䣍	djnb
㪑	djnc
剦	djnj
鵪	djno
䂺	djsy
䃏	djtg
厬	djtk
㪶	djuf
礘	djxo
䃂	djxx
夻	dkf
磾	dkkf
礹	dkkt
磒	dkmy
厛	dkrk
䧺	dkwy
㖛	dkxb
厑	dkxv
䂩	dldy
礋	dlff
㕓	dlff
䦉	dlg
碨	dlge
硨	dlh
䩅	dljb
䩊	dljb
勔	dlje
䩆	dljf
䩍	dlji
蠠	dljj
䩇	dljk
靧	dljm
靤	dljn
䩂	dljn
䩌	dljo
靦	dljq
䩄	dljq
䩉	dljs
䩋	dljs
䩎	dljw
䩏	dljw
䩃	dljx
䩈	dljx
厙	dlk
㕅	dlk
靣	dlkf
硘	dlkg
礧	dlll
䃛	dlph
硱	dlsy
碅	dlty
磥	dlxi
䃩	dmae
冇	dmb
硸	dmdf
顨	dmdj
磞	dmee
磆	dmeg
奝	dmfk
磑	dmgu
㞭	dmj
䰭	dmjc
耎	dmjd
耏	dmje
㓴	dmjj
厠	dmjk
䫱	dmjm
鴯	dmjo
䎡	dmjo
㼲	dmjy
碢	dmnk
硙	dmnn
䫰	dmog
䃬	dmrc
碋	dmsk
頁	dmu
碙	dmum
䃃	dmun
磮	dmwa
䪾	dmwe
硶	dmwn
磪	dmwy
砃	dmyg
䃉	dnaj
尷	dnal
䂥	dnan
乭	dnb
郕	dnbh
㝿	dnbi
镼	dnbm
尮	dnbs
㝾	dnda
㞆	dndk
䫆	dndm
㞄	dndn
㞀	dndo
㞂	dnev
尨	dney
䎁	dng
尪	dngd
㝼	dngf
㼩	dngy
碬	dnhc
碿	dnie
㝽	dnii
㞅	dnjs
㞁	dnjx
尵	dnkm
礔	dnku
㞇	dnle
尳	dnme
尯	dnqb
磖	dnrg
尰	dntf
怘	dnu
㞉	dnua
尲	dnuw
磟	dnwe
砄	dnwy
㞈	dnya
礦	doaw
砿	docy
䂯	dofg
磱	dooe
礯	dooi
㓹	dooj
礳	dosd
䃺	dosd
礏	douf
磄	dovk
䃙	doxx
硡	dpdc
磍	dpdk
碂	dpfi
礗	dpgm
迖	dpi
䃔	dpkk
碦	dptk
硿	dpwa
䃐	dpwd
䃰	dpwi
確	dpwy
碈	dqaj
厎	dqay
奃	dqay
㕋	dqd
硊	dqdb
兣	dqdf
兡	dqdj
䃫	dqdy
勊	dqee
勀	dqet
兞	dqev
尅	dqfi
兙	dqfk
碒	dqg
䂧	dqiy
䂪	dqiy
剋	dqjk
㚚	dqkf
砲	dqnn
鳫	dqoi
鴣	dqoy
䂹	dqoy
䃖	dqoy
䲪	dqoy
䲽	dqoy
奓	dqqu
䃢	dqqw
奅	dqtb
兛	dqtf
碀	dqvh
兝	dqwv
磂	dqyl
镹	dqyy
㼋	drcy
碷	drfh
砶	drg
䂡	drg
磃	drhw
厡	drii
厵	drii
願	drim
䃯	dris
䃇	drmh
磈	drqc
礩	drrm
䫪	drrm
鷞	drro
㼽	drry
䂚	drry
磤	drvc
礫	drxs
礉	dryt
䂨	dryy
䃌	dsfg
磦	dsfi
磗	dsfy
砵	dsgg
矴	dsh
㕊	dsi
磹	dsjh
㿲	dskb
攲	dskc
敧	dskc
砢	dskg
㚡	dskk
䫑	dskm
鵸	dsko
歴	dssh
礎	dssh
暦	dssj
㚞	dssu
厯	dssy
碄	dssy
㚓	dsu
䂞	dsu
硹	dswc
䂾	dsww
矺	dtan
厇	dtav
幚	dtbh
砤	dtbn
硚	dtdj
礄	dtdk
镺	dtdy
䂠	dtdy
厒	dtfb
硞	dtfk
䀇	dtfl
礸	dtfm
䂷	dtfx
硃	dtfy
厜	dtfa
硾	dtfa
䂫	dtgh
㸴	dtgj
镻	dtgy
碫	dthc
厏	dthf
硟	dthp
䂰	dtjh
邫	dtkc
磇	dtlx
礇	dtmd
矻	dtnn
磓	dtnp
磻	dtol
㥻	dtsn
磿	dttd
歷	dtth
厤	dtti
曆	dttj
㷴	dtto
㻺	dtty
㽁	dtty
䃑	dtuc
䃲	dtul
䂢	dtuy
磫	dtwh
㚒	dtyy
硑	duah
蹷	dubh
蟨	dubj
憠	dubn
鷢	dubo
磀	dubp
橜	dubs
㕇	dud
礲	dued
龎	dued
礀	dueg
礈	duep
䃍	duey
㚔	dufj
㚠	dugo
礢	dugv
礒	dugy
㕒	dugy
眘	duhf
䙽	duhq
羍	duj
昚	dujf
䃅	dujf
䃥	dujf
磵	dujg
尞	duji
鷯	dujo
遼	dujp
䨅	dujy
厗	duk
䂱	dukq
磳	dulj
㶫	duou
䂭	dury
磸	dusd
䃹	dusl
冭	duu
磰	duuk
磏	duvw
礠	duxn
砕	dvfh
䃤	dvfj
硉	dvgh
䃗	dvij
䃳	dvln
碯	dvtr
硍	dvy
砓	dwcy
碁	dwdf
䫏	dwdm
㦼	dwea
朞	dwef
憃	dwen
䚎	dweq
䂦	dwet
㚝	dwff
磜	dwfi
䂤	dwfy
碖	dwga
硂	dwgg
䃋	dwgj
硆	dwgk
㕉	dwgk
䳞	dwgo
硢	dwgs
厱	dwgw
礆	dwgw
㫪	dwhj
𡗗	dwi
㫷	dwjf
剘	dwjh
砎	dwjh
惷	dwjn
蜝	dwju
㐞	dwnb
㪛	dwnc
卙	dwnf
䫖	dwnm
䦇	dwnn
夦	dwnq
㽎	dwnq
尠	dwnt
惎	dwnu
㤗	dwnu
歁	dwnw
贗	dwqm
鴈	dwqo
䳢	dwqo
蟴	dwrj
㽄	dwry
棊	dwsu
碸	dwtj
䆐	dwtt
㪸	dwuf
砏	dwvt
郟	dwwb
㪎	dwwc
䂳	dwwf
䃸	dwwg
夾	dwwi
㓨	dwwj
硲	dwwk
贋	dwwm
頰	dwwm
㤲	dwwn
鵊	dwwo
㷳	dwwo
㰰	dwww
㼪	dwwy
砱	dwyc
㕍	dwyd
奞	dwyf
奪	dwyf
諅	dwyf
䧸	dwyg
奮	dwyl
砛	dwyn
㕂	dwyn
䂼	dwyn
磼	dwys
㚛	dxjf
㚕	dxjj
䃨	dxkj
䂗	dxn
礙	dxth
㔫	dxv
䃈	dxxr
磯	dxxw
砪	dxy
䶮	dxyd
䶭	dxyg
詟	dxyy
䃵	dyce
㕈	dyei
䃷	dyey
䃴	dyfj
䂴	dyg
砫	dygg
砯	dyiy
䃄	dyiy
䂖	dykf
䃶	dyle
盇	dylf
䃪	dylg
碻	dymk
砨	dynn
奒	dynw
硋	dynw
硛	dyoy
迏	dypi
碠	dyps
䃚	dytd
䃠	dyth
硠	dyvy
砊	dywn
砇	dyy
臟	eaah
䏼	eaay
毧	eade
臓	eadh
䐙	eafh
膩	eafy
臔	eahm
氁	eajd
臈	eajn
膒	eakk
貙	eakk
臙	eako
貛	eaky
䑏	eaky
貓	ealg
䑅	ealq
朠	eamd
䐟	eamf
䐵	eamw
䐽	eamy
䝡	eamy
朑	eann
䐑	eans
脦	eany
䑃	eape
䐭	eaqh
䐶	eaqj
䏘	eaqn
䝙	eary
㥯	eavn
臒	eawc
㲓	eawi
䥣	eawq
㩓	eawr
㬸	eawx
㬴	eawy
膵	eayf
㬻	eayk
䐠	eayk
鵩	ebco
㲌	ebe
㲗	eben
㔜	ebet
䏪	ebg
朏	ebmh
貀	ebmh
肔	ebn
㐠	ebnn
䳕	ebqo
嗠	ebtk
䏢	eby
䝛	eby
䏜	ebyy
腏	eccc
毶	ecde
蜰	ecju
亂	ecmn
覶	ecmq
辭	ecmu
腬	ecns
䏬	ectg
朘	ecwt
䝜	ecwt
㲧	ecyj
膸	edap
䐛	edbg
胈	edcy
脹	edey
脤	edfe
䢅	edfe
䝟	edhd
脜	edhg
豾	edhg
肨	edhh
䐼	edhi
脴	edhk
䫠	edhm
夓	edht
肧	edhy
腝	edmd
澃	edmi
胹	edmj
盨	edml
䇓	edmu
媭	edmv
嬃	edmv
頾	edmx
須	edmy
䐓	edmy
䫉	edmy
肬	edny
䏵	edny
脄	edoy
䐒	edqq
䝠	edri
䐀	edsk
䝝	edsk
䐻	eduh
膫	edui
䝤	edui
䏾	edwg
䐏	edwj
脥	edww
肰	edy
毝	eee
朤	eeee
脅	eeee
脇	eeee
膬	eeee
䄟	eeei
䝱	eeem
㦌	eeen
劦	eeer
㯔	eees
姭	eeev
脟	eefy
䐘	eegc
䏣	eegg
䑂	eegw
膄	eehc
䏮	eeiy
㲎	een
㽰	eenh
腉	eeqn
貎	eeqn
鵬	eeqo
䐆	eesy
脮	eevg
膎	eexd
貕	eexd
膹	efam
䐦	efcl
胠	efcy
臑	efdj
頱	efdm
㲕	efen
胿	effg
膮	effq
豻	efh
䐈	efhg
䐜	efhw
䏡	efiy
䐍	efku
䏝	efny
䏯	efny
腜	efsy
䐗	eftj
寽	efu
膤	efvg
毀	efwc
臛	efwy
䢸	egbh
胵	egcf
䪶	egdm
鶢	egdo
遯	egep
脿	egey
䐁	egey
䏏	egfh
毬	egiy
脙	egiy
膞	egjf
貆	egjg
刞	egjh
䏸	egkg
腷	egkl
脰	egku
䑔	egmh
䐬	egmj
脼	egmy
礜	egnd
舉	egng
轝	egnl
㐦	egnn
㦛	egnn
舃	egno
鸒	egno
擧	egnr
歟	egnw
與	egnw
譽	egny
㼂	egny
䢐	egpd
鴡	egqo
鶏	egqo
䏞	egsy
胓	eguf
脛	egva
脻	egvh
䑖	egvh
膆	egxi
鄋	ehcb
㪢	ehcc
㲣	ehce
遚	ehcp
毴	ehdd
臄	ehge
貜	ehhc
臞	ehhy
丯	ehk
胋	ehkg
臚	ehll
覓	ehqb
覒	ehqn
䏹	ehqn
辵	ehu
䝞	ehwn
頿	ehxm
䝣	eias
䏴	eieg
毜	eii
㲑	eii
䐝	eimy
脳	eirb
䏚	eitt
膌	eiwe
㸓	ejf
貍	ejfg
䤚	ejfg
貋	ejfh
䏷	ejfh
㦟	ejfn
䐎	ejgh
腸	ejgr
䑗	ejgr
蠫	ejjj
䝢	ejlc
腢	ejmy
㲩	ejnd
腂	ejsy
䐊	ejxx
䐕	ekbg
駕	ekco
䂟	ekdf
㚙	ekdu
毠	ekeb
脵	ekgd
脭	ekgg
膭	ekhm
䑊	ekhp
貚	ekkf
㔔	ekkf
䐷	ekkf
㬽	ekkn
㖙	ekkx
賀	ekmu
䐣	ekmy
乫	eknb
㔖	eknb
㠰	eknb
㤎	eknu
鴐	ekqo
㧝	ekrj
䪪	ekuj
妿	ekvf
嗧	ekwa
胑	ekwy
膕	elag
䐾	elff
腲	elge
輿	elgw
腘	elgy
毸	elni
臅	elqj
㬷	elsy
䐃	elty
膢	elvg
貗	elvg
膃	elwl
䐯	elxi
膿	emae
腨	emdj
貒	emdj
胦	emdy
爯	emff
䏥	emfg
䫇	emfm
臖	emge
舋	emgg
腗	emgj
爂	emgo
㸑	emgo
䐩	emgu
釁	emgv
興	emgw
帠	emhj
䑍	emmv
腡	emnk
膼	emnp
朒	emww
膗	emwy
豽	emwy
㐍	enb
腒	endg
腛	engf
䏤	engk
腵	enhc
貑	enhc
䏔	enhg
䑀	enku
劜	enn
肊	enn
䏱	ennk
䐖	enoy
䐲	enrg
䐅	entd
䏟	entt
鼣	enud
鼫	enud
鼳	enud
鼵	enud
鼱	enue
䶇	enue
鼭	enuf
䶄	enuf
䶈	enuf
鼪	enug
鼦	enuk
鼩	enuk
䶅	enuk
鼲	enul
鼺	enul
䶉	enul
鼰	enum
䶃	enun
鼮	enup
鼨	enuu
鼴	enuv
鼶	enuw
鼸	enuw
鼧	enux
鼤	enuy
鼥	enuy
䶂	enuy
䶆	enuy
膠	enwe
䏐	enwy
胒	enxn
䝚	enxn
臎	enyf
毩	eoi
朥	eooe
腅	eooy
䊆	eou
膅	eovk
毇	eowc
臕	eoxo
膔	eoxx
臗	epay
辤	epcu
迌	epd
腟	epgf
臏	epgm
腪	eplh
愛	epnt
䑟	epqg
䏙	epqn
䴄	epqo
䢬	epqp
貁	epwy
兒	eqb
郳	eqbh
䐢	eqbt
脃	eqcn
膽	eqdy
䐄	eqeg
㪒	eqhc
朓	eqiy
毥	eqjd
豿	eqkg
脕	eqkq
褜	eqne
毱	eqoi
氌	eqoj
䳔	eqou
䐳	eqoy
䳎	eqoy
鶂	eqqo
䏧	eqqy
䐇	eqrj
脗	eqrk
肳	eqrt
䏛	equg
㬹	eqvh
肑	eqyy
朡	erbt
脪	erdh
脈	erey
腯	erfh
胉	erg
貃	erg
肵	erh
䝖	erhy
䏗	ern
㦝	erqn
學	errb
斅	errc
礐	errd
觷	erre
䑁	erre
壆	errf
䁷	errh
䏳	errh
澩	erri
嚳	errk
嶨	errm
䑇	errm
燢	erro
鱟	erro
鷽	erro
䮸	erro
覺	errq
斆	errt
黌	errw
雤	erry
㽇	erry
貏	ertf
䑈	erxs
毢	esd
腖	esjg
䐺	esjh
胢	eskg
脨	eskg
䝗	esy
㭀	etaw
胣	etbn
䏦	etdg
䏺	etdh
膖	etdp
䍃	etfb
㸒	etff
䏕	etfg
㬳	etfh
颻	etfj
㬶	etfk
臜	etfm
臢	etfm
鷂	etfo
脡	etfp
毨	etfq
飖	etfr
䏭	etfy
腁	etgf
腄	etfa
腫	etgf
胮	etgh
脌	etgh
膴	etgo
臐	etgo
胻	etgs
胅	etgy
腶	ethc
䝥	ethf
䑄	ethj
䏒	ethn
脠	ethp
脷	etjh
膓	etjr
䢉	etle
䝦	etli
膍	etlx
䐿	etmd
爳	etnb
鄬	etnb
䏨	etng
噕	etnk
肐	etnn
爲	etno
膇	etnp
胏	etnt
膰	etol
䐐	etoy
貈	etuy
腇	etvg
䐫	etwh
㲮	etwk
脢	etxy
爫	etyt
䐤	euag
䑘	euag
朧	eued
䏠	eug
腃	eugb
勝	euge
膶	eugg
䲢	eugg
幐	eugh
膡	eugh
㬺	eugh
縢	eugi
螣	eugj
賸	eugm
騰	eugo
鰧	eugo
黱	eugo
榺	eugs
䑆	eugv
謄	eugy
羘	euh
朣	eujf
腤	eujg
毰	eukd
䏽	eukg
㬵	eury
䑌	eusl
䐮	eutg
膁	euvw
膉	euwl
貖	euwl
䏲	euxt
䐚	evbh
墾	evff
䐸	evfg
䐹	evfj
肗	evg
貄	evgh
爭	evhj
䐂	eviy
䐉	evlg
臘	evln
㲱	evln
肍	evn
懇	evnu
鵎	evqo
㼏	evry
腦	evtr
貇	evy
䏰	evyn
肒	evyy
肕	evyy
䐋	ewcn
䐥	ewcn
䝘	ewcy
肸	ewfh
胕	ewfy
腀	ewga
毺	ewgj
膾	ewgj
貐	ewgj
䑕	ewgj
䏩	ewgk
肹	ewgn
膯	ewgu
臉	ewgw
䐰	ewhe
脫	ewkq
䝿	ewmu
惥	ewnu
䏫	ewsy
斞	ewuf
朌	ewvt
腳	ewwb
䑎	ewwg
䐪	ewyb
朎	ewyc
㲝	ewyd
脽	ewyg
肣	ewyn
腍	ewyn
臇	ewyn
㲐	ewyn
膲	ewyo
䏎	ewyy
谿	exdk
䫣	exdm
鷄	exdo
㰿	exdw
雞	exdy
腞	exey
䏖	exhh
乿	exin
胇	exjh
膙	exkj
膷	extb
䐞	exuu
䏶	exxf
肶	exxn
豼	exxn
胟	exy
朜	eybg
脝	eybh
㬿	eybt
㲙	eyck
䑉	eyey
臍	eyjg
䑋	eyke
氊	eylg
䐧	eymk
䐔	eyna
䳮	eyno
肞	eyry
䐱	eyud
腣	eyuh
膱	eyuj
朖	eyvy
脺	eywf
膟	eyxf
胘	eyxy
卋	faf
鼖	fafc
㘽	fafd
㦳	fafd
墸	fafj
㔺	fafj
䨣	fafj
壒	fafl
臷	fagf
墷	fagg
尭	fagq
韯	fahg
壏	fahl
𢦏	fai
㦮	fai
塻	fajd
㫩	fajf
蛓	faji
墐	fakg
塸	fakk
㙺	fakm
壦	faky
載	falk
䵧	falo
㙹	falq
霙	famd
翸	famn
䴅	famo
賁	famu
墴	famw
歕	famw
胾	famw
㙢	famy
烖	faoi
靀	fape
墆	faqh
䳒	faqo
䳣	faqo
㦲	faqe
㢤	faqy
㘷	fary
酨	fasg
䫙	fasm
枽	fasu
桒	fasu
䘁	fawj
塂	fawn
塨	fawn
埖	fawx
垬	fawy
塃	fayk
䨸	fben
䨡	fbib
壭	fbj
凷	fbk
逇	fbpv
䨯	fbsj
垜	fbsy
霳	fbtg
壣	fbxg
雭	fbyu
弆	fcaj
叝	fcbc
䢵	fcbh
㙍	fccc
墋	fcce
頍	fcdm
䪺	fcdm
叆	fcec
䂲	fced
攰	fcee
埇	fceh
㲍	fcev
䨶	fchn
䖔	fchw
刦	fcjh
朅	fcjn
坮	fckg
唟	fckx
䫦	fclm
霧	fcne
霿	fcnh
㘧	fcnh
霱	fcnk
雺	fcnt
霚	fcnt
迲	fcpi
鳷	fcqo
䲰	fcqo
㰦	fcqw
䰟	fcrc
攳	fcvf
叇	fcvp
刧	fcvt
刼	fcvy
埈	fcwt
䧴	fcwy
鼁	fcxf
堶	fdae
坺	fdcy
㙽	fddj
䨖	fdef
㙊	fdey
雼	fdf
堐	fdff
坧	fdg
堿	fdgk
㙳	fdgn
㙎	fdgv
墄	fdhi
䨮	fdhv
壥	fdlf
䰰	fdmc
堧	fdmd
㘵	fdmh
顬	fdmm
頇	fdmy
䨲	fdmy
墭	fdnl
垯	fdpy
塽	fdrr
埼	fdsk
垹	fdtb
壢	fdth
靂	fdth
㙩	fdui
㙭	fduw
墈	fdwe
埲	fdwg
堾	fdwj
䨢	fdwn
埉	fdww
㙋	fdwy
雮	feb
䨗	febf
垺	febg
協	feee
㙝	feee
䨜	feef
塪	feeg
埓	fefy
坥	fegg
㘪	fen
堄	feqn
㙾	ferb
霢	fere
埰	fesy
㔹	fet
㘦	fet
霡	feyi
壩	ffae
墳	ffam
邽	ffbh
邿	ffbh
䨺	ffcc
䨭	ffce
霴	ffci
靅	ffcm
霒	ffcn
霕	ffcn
霼	ffco
靆	ffcp
靉	ffct
雲	ffcu
壖	ffdj
劸	ffet
亖	fff
雸	fff
墵	fffc
垚	ffff
堼	ffff
壵	ffff
鞤	ffff
㙓	ffff
犎	fffg
幇	fffh
幫	fffh
顤	fffm
翹	fffn
䴃	fffo
遶	fffp
堯	fffq
墝	fffq
㚁	fffq
㨍	fffr
㜂	fffv
㪈	ffhc
隷	ffii
䨪	ffjf
刲	ffjh
㘫	ffjh
䨍	ffjj
墘	ffjn
䖯	ffju
郌	ffkc
壊	ffle
鄠	ffnb
壔	ffnf
奊	ffny
霊	ffof
麉	ffox
㙪	ffpu
䨌	ffqb
坃	ffqn
䳏	ffqo
㰪	ffqw
㘼	fftn
䶬	ffud
墶	ffup
墻	ffwk
堎	ffwt
鼃	ffxf
䵷	ffxg
坉	fgbn
䨝	fgef
埥	fgeg
㙇	fgey
埡	fgfg
䥅	fggq
墕	fgho
雫	fghu
圷	fghy
塼	fgjf
㙧	fgjl
㚂	fgke
堛	fgkl
壃	fglg
㽍	fgny
霋	fgvv
坘	fgxg
塐	fgxi
䨑	fgxw
趞	fhaj
䞪	fhar
趪	fhaw
䞖	fhay
䟒	fhay
趉	fhbm
䞵	fhcc
䞻	fhce
䟃	fhce
䞭	fhct
䞠	fhdd
䞥	fhde
䞜	fhdh
䟐	fhdh
䞯	fheb
赲	fhee
㱏	fhf
䞚	fhfc
䞨	fhff
䟈	fhfg
䞽	fhfi
趌	fhfk
䞸	fhfk
䞰	fhfo
趬	fhfq
䞗	fhft
䟌	fhfy
圵	fhg
㚀	fhga
壉	fhge
垰	fhgh
䞙	fhgh
䟄	fhgm
䟎	fhgm
䞛	fhgn
趰	fhgr
䞝	fhgy
䟊	fhhe
趠	fhhj
趈	fhhk
埗	fhht
埱	fhic
趙	fhie
赻	fhit
䟂	fhjc
趕	fhjf
䞡	fhjg
䟆	fhjg
趧	fhjh
䞶	fhjr
趗	fhkh
趮	fhks
嗭	fhkx
㼭	fhky
䟉	fhlj
壚	fhll
塷	fhlo
趩	fhlw
赸	fhmk
䞴	fhmk
趐	fhnd
趘	fhne
垇	fhng
䞷	fhnm
悳	fhnn
䵺	fhnn
惪	fhnu
赽	fhnw
趯	fhny
趤	fhpd
赿	fhqa
䨘	fhqb
趛	fhqd
趂	fhqi
趒	fhqi
䞤	fhqk
垷	fhqn
䙿	fhqn
趜	fhqo
趍	fhqq
䨳	fhqq
趨	fhqt
赹	fhqu
赼	fhqw
趆	fhqy
䟋	fhqy
䞟	fhrd
䞹	fhrg
䞺	fhrh
赾	fhrk
䞧	fhrk
䟏	fhrs
䞾	fhrw
䞣	fhry
趚	fhsk
䞬	fhtb
趏	fhtd
趎	fhtf
㙤	fhtf
䞢	fhtf
趃	fhtg
趫	fhtk
䞦	fhtk
趲	fhtm
䞘	fhtn
趀	fhtt
䞲	fhty
䟍	fhty
䟀	fhua
趇	fhud
﨣	fhuf
趥	fhug
趦	fhuk
䞳	fhuk
趢	fhvi
䞫	fhvk
䟁	fhvs
䟑	fhwa
趖	fhwf
䞩	fhwk
䞱	fhwk
顛	fhwm
赺	fhwn
趝	fhwn
㙈	fhwn
㥲	fhwn
趭	fhwo
鷏	fhwo
趓	fhws
䞮	fhws
㒹	fhww
埧	fhwy
趡	fhwy
䞼	fhxe
䞞	fhxj
䟇	fhxw
圤	fhy
㱐	fhyi
䨰	fiaf
霟	fiaw
靋	fidh
霮	fidn
䨟	fiff
祘	fifi
䨕	figf
垙	figq
䨔	figq
霑	fihk
埫	fimk
霘	fimk
礼	finn
壋	fipl
霃	fipq
䨵	fisj
䨬	fiss
霂	fisu
䨙	fitf
垱	fivg
霗	fiwc
塉	fiwe
霐	fixc
霔	fiyg
霶	fiyy
壜	fjfc
坓	fjff
塒	fjff
㘿	fjfg
垾	fjfh
㐩	fjfj
亁	fjfn
場	fjgr
刌	fjh
汬	fjiu
龺	fjj
㓝	fjjh
霷	fjjr
䗣	fjju
塭	fjlg
堣	fjmy
電	fjnb
韓	fjng
䎐	fjng
乹	fjnn
堨	fjqn
䨠	fjqn
堁	fjsy
刱	fjvw
㲦	fjwe
幹	fjwf
螒	fjwj
鶾	fjwo
䮧	fjwo
榦	fjws
倝	fjwy
雗	fjwy
㙷	fjxo
堒	fjxx
㣋	fjye
丼	fjyi
郆	fkbh
霵	fkby
頡	fkdm
埍	fkeg
遠	fkep
㔛	fker
劼	fket
喆	fkfk
嚞	fkfk
墤	fkhm
壝	fkhp
㓤	fkjh
㪮	fkkc
䰱	fkkc
龗	fkkd
喪	fkke
墠	fkkf
霝	fkkk
賷	fkkm
堮	fkkn
䴒	fkko
䚖	fkkq
壧	fkkt
孁	fkkv
靈	fkkw
霣	fkmu
塤	fkmy
翓	fkng
㐖	fknn
迼	fkpd
臺	fkpf
鴶	fkqo
欯	fkqw
㙅	fksy
皷	fkub
敼	fkuc
鼔	fkuc
䵽	fkuc
鼚	fkue
壴	fkuf
尌	fkuf
鼞	fkuf
噽	fkug
鼘	fkug
蟚	fkuj
鼜	fkuj
䶁	fkuj
嚭	fkuk
囍	fkuk
鼛	fkuk
䵿	fkuk
䶀	fkuk
壾	fkun
憙	fkun
䥢	fkuq
鼕	fkuu
鼟	fkuu
歖	fkuw
㰻	fkuw
㖝	fkxb
霬	flaw
堌	fldg
㘻	fldy
㙕	fleg
㿻	flf
墿	flff
靐	flfl
䨻	flfl
㙗	flge
堽	flgh
䨓	flkf
夁	flld
靁	flll
㙼	flll
皾	flmb
䢱	flmp
覿	flmq
賣	flmu
㥁	flnn
䢮	flpd
畞	flqy
塿	flvg
堺	flwj
霻	fmau
㙉	fmaw
堓	fmdf
㙐	fmdj
雵	fmdu
靊	fmdu
坱	fmdy
塴	fmee
㘱	fmfg
霌	fmfk
㱿	fmgc
塏	fmgu
圸	fmh
坰	fmkg
堝	fmnk
䨤	fmpu
堈	fmum
遖	fmup
埛	fmwk
埁	fmwn
墔	fmwy
㘨	fmwy
垻	fmy
魗	fnac
壽	fnaf
垊	fnan
翿	fnan
㦞	fnan
燾	fnao
㐊	fnb
㐋	fnb
逺	fnep
䨒	fnf
墛	fnff
霨	fnff
堩	fngg
壻	fnhe
堳	fnhg
覟	fnhq
韨	fnhy
夀	fnkf
㙔	fnkg
壀	fnku
圠	fnn
毐	fnnd
迃	fnpv
霫	fnrf
忈	fnu
塀	fnua
䬠	fnuh
亐	fnv
㘲	fnvn
聲	fnwb
殸	fnwc
㲆	fnwc
漀	fnwi
韾	fnwj
毊	fnwk
㲈	fnwk
䡰	fnwl
㷫	fnwo
鏧	fnwq
撀	fnwr
㿦	fnwr
㯏	fnws
䅽	fnwt
㲇	fnwu
㘮	fnyy
䞑	foag
墌	foao
壙	foaw
垿	foch
頳	fodm
䞕	fofj
䞓	foga
赪	fohm
赬	fohm
覝	fohq
䚂	fohq
㙻	fojf
赨	fojy
䞒	fomk
赮	fonc
䞔	fone
赯	fook
埮	fooy
赩	foqc
赥	foqw
灻	fou
㶣	fou
䨴	fouf
墣	foug
塶	foxx
郣	fpbb
愂	fpbn
鵓	fpbo
㪍	fpbt
㙆	fpdc
蠧	fpdj
槖	fpds
豰	fpfc
塜	fpfe
霥	fpfe
壺	fpfg
垨	fpfy
皼	fpgb
嗀	fpgc
榖	fpgc
殼	fpgc
瑴	fpgc
瞉	fpgc
穀	fpgc
糓	fpgc
縠	fpgc
轂	fpgc
鷇	fpgc
嗀	fpgc
㜌	fpgc
㝅	fpgc
㲄	fpgc
㲉	fpgc
㷤	fpgc
㺉	fpgc
䍍	fpgc
䐨	fpgc
㘾	fpgf
塇	fpgg
壼	fpgg
埞	fpgh
螜	fpgj
靌	fpgm
亄	fpgn
愨	fpgn
㦤	fpgn
壸	fpgo
鷧	fpgo
㱅	fpgw
塚	fpgy
塓	fpju
辻	fpk
迀	fpk
壷	fpkg
堚	fplh
疐	fplh
㚄	fplh
埦	fpqb
売	fpqb
㨌	fprc
㚃	fpru
坾	fpsh
垞	fpta
垵	fpvg
埪	fpwa
殻	fpwc
堗	fpwd
塎	fpwk
坈	fpwn
慤	fpwn
靏	fpwo
堔	fpws
㙀	fpwv
坹	fpwy
壱	fpxb
䨩	fpyh
坁	fqan
圥	fqb
邧	fqbh
兘	fqck
㘬	fqcy
垝	fqdb
㹕	fqdg
頑	fqdm
㙴	fqdy
埳	fqeg
埆	fqeh
坖	fqff
㝴	fqfi
㒬	fqgd
㒮	fqge
雿	fqiu
垗	fqiy
刓	fqjh
坸	fqkg
垉	fqnn
塢	fqoy
鳱	fqoy
䲧	fqoy
䲺	fqoy
靎	fqqo
䲮	fqqo
䲶	fqqo
垑	fqqy
䨚	fqrn
圽	fqrt
㪴	fquf
鋆	fquq
埩	fqvh
䤰	fqwq
黿	fqxf
朮	fqyi
塯	fqyl
霤	fqyl
怷	fqyn
㫄	fqyr
圴	fqyy
㽌	fqyy
堫	frbt
坬	frcy
坵	frg
堭	frgg
塊	frqc
㙃	frwy
墽	fryt
䣢	fsab
耯	fsac
䎯	fsag
耤	fsaj
耟	fsan
䎰	fsar
䣂	fsbh
耚	fsby
耛	fsck
頛	fsdm
䎨	fsdn
耰	fsdt
耡	fsee
耝	fseg
耞	fsek
墂	fsfi
㙛	fsfy
耫	fsgm
圢	fsh
鹴	fshg
鸘	fsho
䎪	fsjf
埬	fsjg
墰	fsjh
㽑	fsjh
䎬	fslc
堜	fslg
耬	fslv
䎱	fslx
䎤	fsnk
䎣	fsnw
耮	fsoe
䎦	fsoo
䨛	fsrj
䎫	fsrt
㼍	fsry
䨷	fssc
霦	fsse
耓	fssh
塛	fssy
䎢	fstn
䎭	fstp
雬	fsu
䎧	fsuk
㙘	fsvg
䎩	fsvl
耣	fswa
䎥	fswk
䨫	fswq
耭	fsxw
䎮	fsyd
耲	fsye
䨋	ftab
圫	ftan
孷	ftdb
氂	ftde
釐	ftdf
犛	ftdg
甛	ftdg
埄	ftdh
漦	ftdi
墧	ftdk
塳	ftdp
剺	ftdv
斄	ftdw
垁	ftdy
耂	fte
㲠	fteb
㘯	ftet
圲	ftfh
埵	ftfa
堹	ftgf
耊	ftgf
墲	ftgo
壎	ftgo
垳	ftgs
㼥	ftgy
塅	fthc
垍	fthg
䀋	fthl
鼒	fthn
㙞	fths
殾	ftjc
䰩	ftjc
䬡	ftjh
䘄	ftjj
䡤	ftjl
乽	ftjn
䎞	ftjn
煑	ftjo
覩	ftjq
塲	ftjr
斱	ftjr
㙏	ftjt
㗯	ftjx
垎	ftkg
塩	ftkl
㙖	ftky
䨞	ftky
墺	ftmd
塮	ftmf
㠻	ftmh
霺	ftmt
垖	ftng
塠	ftnp
䨨	ftnp
墦	ftol
耇	ftqk
㹈	fttg
耉	fttk
䨱	fttt
垀	ftuf
雽	ftuf
塖	ftux
㙡	ftwh
㙮	ftwk
耈	ftxk
㖈	ftxk
䎛	ftxk
㐗	ftxn
䎝	ftxn
䳓	ftxo
䎜	ftxx
㙁	ftxy
坆	fty
攼	fty
圦	ftyy
壌	fuae
垪	fuah
壠	fued
靇	fued
雴	fuf
報	fufc
褺	fufe
墊	fuff
㘰	fufh
䠟	fufh
漐	fufi
縶	fufi
蟄	fufj
盩	fufl
贄	fufm
慹	fufn
騺	fufo
鷙	fufo
䲀	fufo
逹	fufp
䥍	fufq
摯	fufr
執	fufy
瓡	fufy
謺	fufy
㼬	fufy
埢	fugb
堘	fugf
㙚	fugg
坢	fugh
㙿	fugy
垟	fuh
垶	fuh
墥	fujf
堷	fujg
墹	fujg
墇	fujh
㙥	fuke
㙂	fukq
増	fulj
達	fupk
壛	fuqe
䨏	fuqw
墫	fusf
壿	fusf
墡	fuuk
㽐	fuvw
䨧	fuwc
塧	fuwl
霠	fuwn
赱	fuyu
垏	fvgh
壗	fvhl
㙌	fvhw
埐	fvpc
堖	fvtr
㘺	fway
塕	fwcn
坄	fwcy
垘	fwdy
㙯	fwfc
勎	fwfe
勢	fwfe
坴	fwff
暬	fwfj
䞇	fwfm
熱	fwfo
燅	fwfo
驇	fwfo
鵱	fwfo
摰	fwfr
槷	fwfs
坿	fwfy
埶	fwfy
埨	fwga
堬	fwgj
垥	fwgk
䨐	fwgk
墖	fwgl
墱	fwgu
霯	fwgu
䨹	fwho
圿	fwjh
堢	fwks
㙸	fwog
堸	fwtj
夌	fwtu
雰	fwvr
坋	fwvt
䘮	fwwe
嗇	fwwk
﨏	fwwk
賫	fwwm
㱇	fwww
墢	fwxc
鼀	fwxf
坽	fwyc
䨥	fwyc
䧲	fwyg
坅	fwyn
靍	fwyo
鸖	fwyo
䴇	fwyo
㙫	fwys
㱋	fwyw
靃	fwyy
䨎	fxcu
㙣	fxde
堟	fxey
塡	fxhw
坲	fxjh
㘭	fxnn
㙄	fxxf
㘩	fxxn
堦	fxxr
㙨	fxxw
霛	fxxx
墎	fybb
霩	fybb
埻	fybg
堉	fyce
霅	fyf
圡	fyi
霽	fyjf
靄	fyjn
壞	fyle
壇	fylg
壈	fylt
㙵	fymf
塙	fymk
塆	fyox
雱	fyr
墑	fyud
塝	fyuy
䨦	fyuy
㙟	fyve
埌	fyvy
埣	fywf
壪	fyxx
㙲	fyxy
琖	gaay
㦱	gafd
瓂	gafl
弐	gafy
玒	gag
璍	gagg
㼛	gagy
㺿	gahh
璼	gahl
䝾	gahm
鵡	gaho
䙹	gahq
玡	gaht
虣	gahw
刬	gajh
琙	gakg
瓘	gaky
㿼	galf
䵤	galo
璊	gamy
貮	gamy
䍾	gang
玴	gann
㻡	gans
烎	gaou
䢎	gapk
㻸	gaqj
㻤	gaqk
鳽	gaqo
璥	gaqt
㰢	gaqw
璓	gatb
㻳	gatj
瓁	gawc
瑹	gaws
雃	gawy
瑘	gbbh
㻓	gbcy
瓍	gbdp
㺭	gbg
邞	gbh
邨	gbnb
旾	gbnj
頓	gbnm
迍	gbnp
㼊	gbny
㐪	ybwu
㺹	gcah
戩	gcca
晉	gccj
㻆	gceg
臶	gcfb
臸	gcff
㬜	gcfj
䶍	gcfj
臵	gcfk
臹	gcfn
鵄	gcfo
䑒	gcfy
珆	gckg
璚	gcnk
瑈	gcns
瑪	gcoy
玧	gcqn
丟	gcu
㻐	gcwt
㺨	gcy
瑵	gcyj
㻟	gdae
珛	gdeg
瓇	gdet
郉	gdfb
幵	gdfh
栞	gdfs
珬	gdgg
蝅	gdgj
蠺	gdgj
瑊	gdgk
珔	gdhb
㪪	gdhc
䨿	gdhd
㺽	gdhg
䪞	gdhg
玤	gdhh
㻰	gdhv
沗	gdiu
奣	gdje
昋	gdjf
䗞	gdjj
䘉	gdjj
䵡	gdlo
瑌	gdmd
頊	gdmy
珹	gdnn
㤁	gdnu
迗	gdpi
鴌	gdqo
瓑	gdth
㺯	gdu
璙	gdui
璂	gdwf
琫	gdwg
瑃	gdwj
㻣	gdwn
瑧	gdwt
㺴	gdy
䨼	geac
䝔	geay
䝕	gebb
䝐	gebe
琈	gebg
郬	gebh
䝒	gebi
䝌	gecc
豝	gecn
豲	gedi
豯	geed
珕	geee
瑫	geeg
豠	geeg
㻚	geeg
靜	geeh
䝅	gefg
豬	gefj
豮	gefm
豶	gefm
櫫	gefs
豷	gefu
玥	geg
豜	gega
豩	gege
豣	gegf
珇	gegg
䝊	gegh
豘	gegn
璵	gegw
靚	gehq
靗	geiq
蟸	gejj
豱	gejl
䀃	gelf
䝏	gelv
䝎	gemj
豭	genc
䝋	gepi
䝍	gepl
璦	gept
靘	geqc
䴖	geqg
豞	geqk
鶄	geqo
䝈	gerb
豨	gerh
靔	gern
靝	gero
豧	gesy
玏	get
甤	getg
豵	geth
䝑	geuf
䝓	gevn
豤	gevy
豛	gewc
豴	geyd
豖	geyi
剢	geyj
豟	geyn
豥	geyw
邘	gfbh
瓀	gfdj
珪	gffg
㻬	gffn
玵	gfg
亞	gfgd
堊	gfgf
蝁	gfgj
惡	gfgn
鵶	gfgo
䢝	gfgp
㰳	gfgw
琧	gfgy
玕	gfh
瑱	gfhw
琎	gfjp
瓄	gflm
璹	gfnf
㺮	gfnn
瓙	gfno
琽	gftj
珯	gftx
㪀	gfty
㼀	gfup
珷	ggay
玗	ggfh
玨	ggg
龶	gggg
瓉	gggm
璱	gggt
䣠	ggjb
瑼	ggjf
璢	ggjl
璤	ggjn
珸	ggkg
鄻	gglb
輦	gglj
鄼	ggmb
㺰	ggmh
㺻	ggmh
賛	ggmu
玙	ggng
㐄	ggnh
珁	ggny
瑨	ggoj
璈	ggqt
琹	ggsu
玶	gguf
珡	ggwu
瑇	ggxy
玞	ggy
㚘	ggy
㺳	ghcy
㠪	ghd
琲	ghdd
頙	ghdm
㒫	ghfq
㺺	ghg
瓛	ghgd
靕	ghge
䢥	ghhp
㻉	ghht
琡	ghic
琸	ghjh
丅	ghk
瓐	ghll
乤	ghnb
亙	ghng
丏	ghnn
璿	ghph
鬹	ghqh
現	ghqn
規	ghqn
鴊	ghqo
槼	ghqs
嫢	ghqv
㻯	ghtf
颪	ghwj
玼	ghxn
㺪	ghy
璖	gias
琑	gieg
琺	gifc
珖	gigq
瑣	gimy
瑺	giph
璫	gipl
珰	givg
珱	givg
皳	giyb
䣇	giyb
盚	giyl
慦	giyn
䥭	giyq
㐜	giyv
㻫	gjag
畱	gjal
丣	gjan
䪲	gjdm
瑅	gjgh
刯	gjgj
瑒	gjgr
㺫	gjh
鄟	gjhb
專	gjhf
珅	gjhh
剸	gjhj
鷒	gjho
甎	gjhy
琩	gjjg
㻴	gjlc
瑥	gjlg
㻦	gjmy
䢋	gjpk
㻛	gjqr
郠	gjrb
甦	gjrg
㪽	gjrj
㬲	gjrl
䢚	gjrp
㻀	gjry
瑆	gjtg
璟	gjyi
琝	gjyy
郚	gkbh
琄	gkeg
丗	gmk
㻍	gkgd
珵	gkgg
帯	gmph
玔	gkh
叓	gkhc
嚢	gkhe
蟗	gkhj
璝	gkhm
䝴	gkhm
櫜	gkhs
㯱	gkhs
㯻	gkhs
㰆	gkhs
栆	gkhu
珿	gkhy
亜	gkjg
悪	gkjn
䫷	gkkm
璪	gkks
畐	gklf
疈	gkll
㽬	gkll
鶝	gklo
䣓	gkmb
䰙	gkmc
鞷	gkmf
鹝	gkmg
䰝	gkmj
鬸	gkml
鷊	gkmo
鬺	gkmr
鬴	gkms
鬷	gkmt
䰚	gkmy
䰛	gkmy
㐚	gknb
逜	gkpd
䢩	gktp
敔	gkty
郖	gkub
䜵	gkub
䜴	gkuc
䜷	gkuc
䝄	gkuc
毭	gkue
䜸	gkue
豍	gkuf
㪷	gkuf
䜶	gkug
䜻	gkuh
剅	gkuj
䜺	gkuj
䜽	gkuj
䜾	gkuj
䜹	gkuk
䝀	gkul
頭	gkum
㐙	gkun
䜳	gkun
䝃	gkuo
豏	gkuw
㰯	gkuw
剚	gkvj
珚	gldy
環	glge
畺	glgg
玾	glh
卌	glk
㻁	glkg
瓃	glll
璉	glpy
㻿	glqj
㻒	glty
㻲	glvg
㐁	glwi
琾	glwj
㼈	glxy
琠	gmaw
㓰	gmbj
襾	gmbk
叀	gmcu
勣	gmet
珃	gmfg
琱	gmfk
専	gmfu
㔝	gmhe
靑	gmhg
䴓	gmhg
䪟	gmhg
䪣	gmhg
巿	gmhk
帀	gmhk
鳾	gmho
迊	gmhp
䢌	gmhp
䚍	gmhq
兩	gmhy
曺	gmjf
㺾	gmkg
両	gmmk
瓔	gmmv
恵	gmnu
鬶	gmqh
椝	gmqs
責	gmu
㪅	gmwc
瓗	gmwk
琌	gmwn
㼇	gmwn
㶮	gmwo
珼	gmy
酈	gmyb
彨	gmye
彲	gmye
玬	gmyg
鸝	gmyo
邐	gmyp
䚕	gmyq
婯	gmyv
麗	gmyx
瑉	gnaj
㐏	gnb
㻵	gnbb
㻕	gnbm
珝	gng
瑂	gnhg
㺲	gnhg
㺩	gnhh
㔿	gnhk
㺼	gnhy
㝳	gni
瑋	gnkg
玌	gnn
玘	gnn
邷	gnnb
瓪	gnnc
瓱	gnne
瓧	gnnf
瓩	gnnf
瓼	gnnf
甅	gnnf
瓸	gnnj
瓲	gnnn
瓰	gnnv
戸	gnr
玚	gnrt
珌	gntt
攷	gnty
忢	gnu
丂	gnv
璆	gnwe
玦	gnwy
璻	gnyf
㼅	goaw
鄑	gojb
㼆	gooy
璘	goqg
䴡	gotx
辷	gpd
迋	gpd
琓	gpfq
瑄	gpgg
琔	gpgh
璸	gpgm
璌	gpgw
㻘	gpjh
琿	gplh
璭	gplp
琯	gpng
瑸	gprw
㻠	gpwd
瑢	gpwk
瑏	gpwt
殘	gqaa
殣	gqag
殢	gqah
琘	gqaj
尶	gqal
殜	gqas
㤪	gqbn
㱟	gqby
䬸	gqcv
麺	gqdf
㱠	gqdg
㱹	gqdh
㱦	gqdk
殗	gqdn
殑	gqdq
殝	gqdt
殎	gqdw
㱚	gqeg
㱣	gqev
㱩	gqfd
㱶	gqfe
殱	gqfg
殰	gqfm
㱵	gqfm
㱥	gqft
琻	gqg
殌	gqga
尫	gqgd
豗	gqge
殭	gqgg
㱴	gqgm
㱙	gqgn
㱛	gqgq
㻧	gqgs
殏	gqgy
㱺	gqhl
殩	gqho
㱜	gqhy
珎	gqiy
䶛	gqjb
劽	gqje
珣	gqjg
䴕	gqjg
㡂	gqjh
殟	gqjl
㽝	gqjl
㤠	gqjn
烮	gqjo
鮤	gqjo
鴷	gqjo
迾	gqjp
銐	gqjq
姴	gqjv
殫	gqkf
玽	gqkg
殞	gqkm
殨	gqkm
㱮	gqkm
㻊	gqkq
㱬	gqle
殬	gqlf
瑍	gqmd
瓊	gqmt
㱯	gqmu
㱪	gqnj
玸	gqnn
㱸	gqnu
瑦	gqoy
鳺	gqoy
鳿	gqoy
㱧	gqpb
㱨	gqph
殯	gqpm
㱰	gqpu
殥	gqpw
卼	gqqb
歿	gqqc
殙	gqqj
殦	gqqo
麹	gqqo
䲫	gqqo
歾	gqqr
㱱	gqrc
歽	gqrh
殐	gqsk
㱫	gqsl
㱤	gqsr
珋	gqtb
瑤	gqtb
㱭	gqtc
殀	gqtd
殠	gqtd
殅	gqtg
嗸	gqtk
殈	gqtl
嶅	gqtm
贅	gqtm
䫨	gqtm
㥿	gqtn
驁	gqto
鰲	gqto
鷔	gqto
㱡	gqtq
䵅	gqtq
摮	gqtr
殤	gqtr
嫯	gqtv
鼇	gqtx
謷	gqty
㱞	gqug
殕	gquk
㱲	gqul
兀	gqv
肂	gqvg
琤	gqvh
殔	gqvi
殲	gqwg
㱷	gqws
飱	gqwv
殮	gqww
㺵	gqwy
㱝	gqxe
㘸	gqxf
㰷	gqxw
瑠	gqyl
㱢	gqyv
殧	gqyy
玓	gqyy
㱻	gqyy
琋	grdh
瑝	grgg
㻈	grgk
瑔	griy
瓆	grrm
琕	grtf
瓅	grxs
璬	gryt
膥	gsdw
㻼	gsjh
㻋	gskg
㻝	gskj
瓎	gskm
唜	gskx
瑓	gslg
㻷	gsmm
璴	gssh
瑮	gssy
琜	gsww
璷	gsyt
㺷	gsyy
㻑	gtbg
琇	gtbt
琒	gtdh
㻱	gtdp
珤	gtfb
玝	gtfh
璳	gtfm
瓚	gtfm
珽	gtfp
珗	gtfq
㻔	gtfa
珄	gtgg
㻄	gtgh
璑	gtgo
瑖	gthc
琍	gtjh
瑀	gtky
珦	gtmk
琁	gtnh
瑡	gtnh
璠	gtol
瓈	gtqi
珴	gtry
珘	gtuy
㻶	gtvg
瑽	gtwh
珻	gtxy
瑳	guag
㻂	guah
刾	gudj
頬	gudm
瓏	gued
瑐	guej
璲	guep
㺶	gufh
㼞	gufy
㼁	gugy
珜	guh
璄	gujq
琣	gukg
璔	gulj
琷	gunn
珓	gury
㻥	gusg
瓓	gusl
慭	gusn
亊	guvh
㻩	guvw
珶	guxt
䣆	gvab
勁	gvae
巠	gvaf
璕	gvaf
剄	gvaj
巰	gvak
頸	gvam
鵛	gvao
逕	gvap
坙	gvff
璛	gvfj
珒	gvgh
郪	gvhb
疌	gvhi
璶	gvhl
鶈	gvho
㼮	gvhy
琭	gviy
㻖	gviy
璅	gvjs
玿	gvkg
㼃	gvln
㻏	gvoy
珺	gvtk
珢	gvy
玱	gwbn
玜	gwcy
㻅	gwfc
㻮	gwfi
㻇	gwgg
珮	gwgh
璯	gwgj
珨	gwgk
珟	gwgq
㻌	gwgs
璒	gwgu
玠	gwjh
壐	gwmf
蠒	gwmj
鸍	gwmo
邇	gwmp
覼	gwmq
爾	gwmr
璽	gwmy
兲	gwu
㻜	gwwh
玐	gwy
㻪	gwyb
琟	gwyg
琀	gwyk
瑲	gwyk
玪	gwyn
㻽	gwyn
璡	gwyp
㺬	gwyy
瑑	gxey
繛	gxij
䋤	gxiy
瑻	gxmy
鴺	gxwo
㼄	gxxl
玭	gxxn
瑎	gxxr
璣	gxxw
璏	gxxx
㻻	gybt
㻙	gyce
珫	gycq
珳	gyet
琂	gyg
玣	gyhy
玊	gyi
璾	gyjg
瓖	gyke
瓌	gyle
璮	gylg
㻞	gyna
㻢	gytb
瓋	gyup
瑯	gyvb
琗	gywf
㻭	gyxf
玹	gyxy
䁥	haak
瞸	haas
䁳	hada
睰	hadk
䁰	hadm
瞱	hagg
頥	hahm
瞙	hajd
䁧	hakg
瞘	hakk
矔	haky
矒	halh
䁾	halw
䁐	hamd
瞞	hamy
歫	hang
眓	hann
㷡	hano
䁋	hans
矇	hape
䁮	haqj
䀙	havt
矆	hawc
䀧	hawy
齰	hbaj
齛	hban
䶙	hban
齖	hbat
齱	hbbc
䶔	hbbn
齝	hbck
䶕	hbcn
齮	hbdk
䶢	hbdk
䶝	hbdw
䶞	hbdw
齟	hbeg
齨	hbeg
齯	hbeq
䶧	hbfq
齻	hbfw
䶪	hbfy
眲	hbg
齬	hbgk
䶦	hbgm
䶥	hbhg
齜	hbhx
齒	hbj
齥	hbjt
齵	hbjy
䶚	hbjy
齪	hbkh
齶	hbkn
䶫	hbkt
齞	hbkw
䁅	hblg
齫	hbls
䶤	hbme
䶡	hbmj
䶣	hbmu
齷	hbnf
齓	hbnn
齳	hbpl
䶟	hbqe
齣	hbqk
齙	hbqn
齺	hbqt
齗	hbrh
齭	hbrr
齼	hbsh
齽	hbsi
䶗	hbsk
齚	hbtf
䶜	hbtk
齕	hbtn
齲	hbty
齴	hbue
䶘	hbug
齸	hbul
齩	hbur
齠	hbvk
齦	hbvy
齡	hbwc
齘	hbwj
䶖	hbwn
䶨	hbww
齔	hbxn
䶩	hbyj
瞲	hcnk
䀵	hctd
䁊	hcyh
䀑	hcyy
矋	hday
郹	hdbh
䁭	hddd
䀼	hdfe
睳	hdff
䀦	hdg
歲	hdgh
歳	hdgi
劌	hdgj
䁍	hdgk
䖗	hdgk
顪	hdgm
翽	hdgn
奜	hdhd
猆	hdhd
靟	hdhe
䩁	hdhe
㹃	hdhg
盽	hdhh
剕	hdhj
輩	hdhl
䪤	hdhl
䩀	hdhm
䫍	hdhm
㐟	hdhn
䨽	hdhn
棐	hdhs
婓	hdhv
餥	hdhv
㻗	hdhy
䁆	hdjn
頉	hdmy
䴗	hdqg
鶪	hdqo
㮂	hwsu
狊	hdu
瞭	hdui
睶	hdwj
䀹	hdww
䋰	hwxi
眬	hdxy
眀	heg
皻	hegb
䣜	hegb
㪥	hegc
䁔	hegc
虘	hegd
覰	hegq
䂃	helf
眊	hen
瞹	hept
䀐	het
䁘	hetb
睜	hevh
睵	hfak
䀷	hfce
眃	hfcy
䁱	hffq
歭	hffy
盰	hfh
瞋	hfhw
眎	hfiy
瞦	hfkk
盶	hfqn
䁄	hfuf
睖	hfwt
矐	hfwy
眛	hfy
䀘	hgah
眰	hgcf
丄	hgd
䀖	hgdy
勮	hgee
豦	hgei
劇	hgej
䁃	hgey
䖉	hgfk
䰘	hgge
鬦	hggf
鬪	hggf
鬥	hggh
鬧	hggh
䰗	hggn
鬩	hggq
鬬	hggr
鬭	hggr
鬫	hggt
鬨	hggw
鬮	hggx
卝	hghg
眐	hghg
羋	hghg
㐀	hghg
茍	hghk
瞡	hghq
羐	hghy
雈	hghy
䁣	hgjf
戲	hgka
齾	hgkb
獻	hgkd
鬳	hgkh
覻	hgkq
䖒	hgku
㱆	hgkw
甗	hgky
眪	hgmw
矖	hgmx
歵	hgmy
瞔	hgmy
䀎	hgnn
眜	hgsy
䀴	hgva
眱	hgxw
顰	hhdf
頻	hhdm
瞁	hhdy
䁦	hheg
䀠	hhg
䂄	hhhc
歮	hhhf
瞐	hhhf
䂂	hhhy
䀡	hhkg
亅	hhll
矑	hhll
鼑	hhnn
愳	hhnu
煛	hhou
瞾	hhpa
鷪	hhpo
睍	hhqn
歨	hhu
戵	hhwa
䣤	hhwb
鸜	hhwo
䢲	hhwp
裻	hice
惄	hicn
錖	hicq
睄	hieg
敊	hihc
矘	hipo
縣	hiti
懸	hitn
歩	hitr
尗	hiu
㦸	hjay
㫖	hjf
睅	hjfh
睼	hjgh
䁑	hjgr
㪕	hjhc
眒	hjhh
䁜	hjiq
戱	hjna
虛	hjng
逴	hjpk
䁙	hjpv
児	hjqb
鵫	hjqo
睗	hjqr
睲	hjtg
㲃	hjxc
䁒	hkbg
梷	hkcs
頕	hkdm
奌	hkdu
睊	hkeg
㣌	hket
睈	hkgg
鸆	hkgo
敁	hkhc
瞆	hkhm
瞶	hkhm
覘	hkhq
㓠	hkjh
瞣	hkkn
矂	hkks
䁚	hkmy
㤐	hknu
迠	hkpd
眖	hkqn
膚	hled
虜	hlee
䁌	hleg
盀	hlf
䁺	hlff
䁼	hlff
䁫	hlfo
䁵	hlge
睤	hlgj
㔽	hlkf
㪭	hllc
盧	hlld
㔧	hlle
顱	hllm
鸕	hllo
䁲	hlmy
勴	hlne
慮	hlni
逌	hlnp
䚃	hlnq
鹺	hloa
鹷	hloc
䴜	hloc
䴝	hloc
䴛	hloe
鹹	hlok
鹶	hlon
鹵	hlou
鹸	hlow
鹻	hlow
鹼	hlow
䴚	hlow
䴞	hloy
禼	hlrc
䁪	hlrh
卥	hlry
睏	hlsy
瞜	hlvg
㮚	hlws
㕟	hmac
䁸	hmae
欳	hmaw
睓	hmaw
眏	hmdy
睭	hmfk
眮	hmgk
䀻	hmgn
䁗	hmgu
卨	hmnk
遉	hmpi
貞	hmu
䁕	hnaj
䵻	hndv
睱	hnhc
睸	hnhg
矚	hnij
県	hniu
䁹	hnku
㢟	hnpv
虙	hnte
䀣	hntt
郻	hnvb
矅	hnwy
䀗	hnwy
眤	hnxn
矌	hoaw
戯	hoay
齢	hobc
歯	hobj
覷	hohq
睒	hooy
瞇	hopy
歔	hoqw
瞨	houg
䁖	hovg
瞊	hovk
虡	howi
肻	hpef
睆	hpfq
叡	hpgc
㕡	hpgc
㕢	hpgc
㪫	hpgc
㲊	hpgc
壡	hpgf
睻	hpgg
䪥	hpgg
䜭	hpgk
矉	hpgm
瞚	hpgw
睴	hplh
矃	hpns
睕	hpqb
眝	hpsh
敹	hptt
睧	hqaj
眂	hqan
眡	hqay
見	hqb
覎	hqbd
䀚	hqbj
㣓	hqce
韰	hqcg
䝳	hqcm
䱗	hqco
㛑	hqcv
䙸	hqfi
䙷	hqfu
䲣	hqgt
覞	hqhq
眴	hqjg
眗	hqkg
眳	hqkg
睌	hqkq
䂁	hqky
矎	hqmt
䱷	hqot
瞗	hqoy
鳪	hqoy
䁩	hqoy
覐	hqrr
䀛	hqrt
䖏	hqry
覹	hqtt
歺	hqu
㱑	hqu
盷	hqug
䁓	hrbt
眅	hrcy
虗	hrd
睎	hrdh
眽	hrey
瞃	hrfh
盺	hrh
矈	hrpy
䁛	hrqc
䀿	hrrh
䁀	hrrj
䁻	hrxs
䁶	hryt
瞫	hsjh
㱒	hskf
䀳	hskg
虨	hsse
䁏	hsvg
睞	hsww
䀯	hsy
䀨	htdg
䀱	htdh
䀢	htdy
䀒	htfh
歱	htgf
瞴	htgo
矄	htgo
䀪	htgs
眣	htgy
㱗	hthd
䀽	hthp
矏	hthy
䖍	hti
䀩	htkg
矀	htmt
䀥	htni
盵	htnn
辪	htnu
矁	hton
睋	htry
虖	htuf
歬	htuu
歑	htuw
瞛	htwh
處	htwv
䀲	htxy
䁟	huag
眹	hudy
矓	hued
瞯	hueg
䀞	hufh
睠	hugb
瞤	hugg
眫	hugh
䂀	hugy
眻	huh
瞷	hujg
瞕	hujh
䁬	hulj
矙	hunt
䁠	huvw
䁡	huwy
睷	hvgp
睩	hviy
眧	hvkg
䁽	hvln
㱕	hvph
䀓	hvyy
䀔	hvyy
虥	hwaa
龁	hwbn
龂	hwbr
瞈	hwcn
䖕	hweg
眕	hwet
甝	hwfd
䖛	hwfi
睔	hwga
䀬	hwgg
睮	hwgj
瞺	hwgj
䀫	hwgk
盻	hwgn
䁯	hwgn
瞼	hwgw
䖜	hwhj
贙	hwhm
覤	hwhq
虤	hwhw
䖑	hwjd
䖌	hwjh
䡞	hwlj
䖖	hwlk
睺	hwnd
䖚	hwqo
虝	hwqr
䖘	hwqy
仧	hwu
凣	hwv
睉	hwwf
䬌	hwwj
䀰	hwwk
虪	hwwo
䖋	hwwy
㱓	hwyc
雐	hwyd
䧳	hwyg
虧	hwyn
眑	hxet
㘹	hxff
祡	hxfi
眥	hxhf
䀕	hxhh
㫮	hxjf
䀟	hxjh
䖪	hxju
歶	hxjy
呰	hxkf
啙	hxkk
㠿	hxmh
貲	hxmu
胔	hxmw
鈭	hxqf
鮆	hxqo
鴜	hxqo
䳄	hxqo
㱔	hxqu
㰣	hxqw
矊	hxrh
㧘	hxrj
㭰	hxsm
䖈	hxv
姕	hxvf
飺	hxwv
䀝	hxxn
䁨	hybb
瞮	hyct
䁁	hyiy
㓺	hyjh
瞓	hykh
䁴	hylg
睙	hynd
眿	hyni
䀮	hynk
盳	hynn
䀭	hynw
䁎	hyps
瞝	hyrc
眆	hyt
䁢	hyth
䁤	hyud
䀶	hyvy
睟	hywf
㱖	hywf
䂅	hyxj
盿	hyy
㳦	iaah
㶓	iaah
灆	iaal
㵩	iaas
淺	iaay
渃	iadk
澒	iadm
頮	iadm
颒	iadm
潵	iaet
㴖	iafh
濭	iafl
洭	iagg
澕	iagg
淽	iahg
洍	iahh
瀶	iahk
濫	iahl
㶊	iahm
灠	iahq
㳻	iajg
濗	iajh
㵧	iajn
澫	iajy
㵄	iakd
淢	iakg
漌	iakg
漢	iakg
漚	iakk
灘	iaky
渵	ialg
瀎	ialw
渶	iamd
溝	iamf
㴂	iamf
満	iamm
懣	iamn
滿	iamy
㳩	iamy
㲺	ian
洰	iang
泧	iann
瀳	iaoo
㳤	iaoy
濛	iape
溁	iaps
滯	iaqh
灊	iaqh
潛	iaqj
懘	iaqn
濍	iaqn
鴻	iaqo
渮	iask
㴀	iatp
㴕	iaty
㵴	iauh
灡	iaul
瀟	iavj
濩	iawc
溚	iawk
濸	iawk
鍙	iawq
㳸	iawx
滙	iawy
㳚	iawy
㳀	iay
浳	iaye
㵏	iayf
㵁	iayk
淓	iayt
灄	ibbb
㵫	ibbj
㵵	ibci
溋	ibcl
碆	ibdf
㴍	ibdi
瀡	ibdp
㶏	iben
汓	ibg
滍	ibhj
洆	ibig
㳱	ibjg
㴠	ibkb
濻	ibkm
䀀	iblf
泏	ibmh
氾	ibn
㳧	ibnn
㴷	ibpq
錃	ibqf
㨇	ibrj
漋	ibtg
㶌	ibxg
㳎	icah
涰	iccc
滲	icce
㴉	iccf
㵕	iccn
湧	icee
㳙	iceg
慂	icen
㴰	icex
㳔	icfy
汿	icnh
沀	icnh
潏	icnk
滪	icnm
澦	icnm
渘	icns
㶠	icof
溤	icoy
沇	icqn
涘	ictd
洠	ictg
㳗	icyf
溞	icyj
㵮	idag
㵦	idap
濿	iday
汯	idcy
沷	idcy
㳒	idcy
瀀	idet
涱	idey
沯	idf
渀	idfa
浱	idfe
漘	idfe
㴎	idfi
㵔	idfj
滣	idfk
洿	idfn
沰	idg
減	idgk
澸	idgn
滅	idgo
洊	idhb
湱	idhd
潔	idhi
㳪	idhk
㳅	idhy
㴟	idjb
湹	idjf
洦	idjg
㳓	idkg
渜	idmd
㳍	idmh
洏	idmj
湏	idmy
㙙	idnf
厳	idnt
沋	idny
浝	idny
洃	idoy
㳠	idpy
漺	idrr
渏	idsk
瀝	idth
㵐	iduw
湊	idwd
淎	idwg
溙	idwi
濝	idwi
湷	idwj
浹	idww
㳁	idwy
汏	idy
汱	idy
湼	ieag
濦	iean
㵬	iebl
㐢	iebn
㳶	iebn
㵻	ieec
淜	ieeg
㲖	ieen
㳫	ief
㶁	iefw
浖	iefy
㳉	ieg
湲	iegc
澙	iego
㵰	iegw
渓	iegy
㴞	iehj
漞	iehq
揱	iejr
泇	iekg
㵑	iekm
灂	ielf
㶀	iene
涭	iepc
淣	ieqn
潟	ieqo
㶅	ierb
灚	ierq
氻	iet
滛	ietb
潙	ieto
㴨	ieud
浽	ievg
淨	ievh
㳛	iewy
㶉	iexg
㴯	iexj
鸂	iexo
瀐	ifag
泋	ifah
渽	ifak
濆	ifam
溨	ifas
瀻	ifaw
㵶	ifay
汥	ifcy
沄	ifcy
㴳	ifdy
坔	iff
澐	iffc
湗	ifff
澆	iffq
洔	iffy
汢	ifg
淔	ifhg
沶	ifiy
澣	ifjf
濣	ifjf
汫	ifjh
漧	ifjn
溒	ifke
㵙	ifkk
㳳	idqn
㵢	iflg
瀆	iflm
湳	ifmf
濤	ifnf
汚	ifnn
浾	ifoy
浡	ifpb
濲	ifpc
瀔	ifpc
瀫	ifpc
溹	ifpi
涜	ifpq
㴾	ifpt
潱	ifpu
㳡	ifpy
㳈	ifqn
㵡	ifqn
灀	ifsh
瀮	ifss
洡	ifsy
湈	ifsy
涍	iftb
洘	iftn
㵭	ifto
漖	iftt
㳣	iftx
涬	ifuf
澾	ifup
澪	ifwc
淕	ifwf
濇	ifwk
淩	ifwt
瀖	ifwy
沬	ify
汧	igah
㳥	igah
洷	igcf
㴛	igct
㴁	igdj
濪	igec
瀞	igeh
瀦	igej
㵾	igeq
汙	igfh
盓	igfl
潖	iggc
濽	iggm
濏	iggt
泟	ighg
漹	igho
浗	igiy
漙	igjf
澑	igjl
潓	igjn
浭	igjr
灢	igke
㴻	igkf
滆	igkh
瀜	igkj
湢	igkl
浢	igku
洅	igmf
淸	igmg
沞	igmh
灑	igmx
漬	igmy
汅	ignn
溍	igoj
䆪	igqa
韑	igqg
㒯	igqg
輝	igql
滶	igqt
兤	igqw
黋	igqw
尡	igqx
泙	iguf
涇	igva
淒	igvv
挙	igwr
濔	igwr
溼	igxf
沍	igxg
溸	igxi
洟	igxw
渄	ihdd
濊	ihdh
湨	ihdy
沚	ihg
澽	ihge
㴐	ihgn
澁	ihhh
瀕	ihhm
灈	ihhy
渉	ihit
渋	ihiy
澞	ihkd
惉	ihkn
瀘	ihll
濾	ihln
滷	ihlo
湞	ihmy
濎	ihnn
濬	ihph
覍	ihqb
涀	ihqn
澯	ihqo
滮	ihwe
淲	ihwn
泚	ihxn
⺌	ihyt
氺	ihyy
㶂	iiaw
濷	iiay
㴺	iidw
㳲	iidy
㵜	iiff
洸	iigq
㴣	iigw
㵘	iiii
尛	iiiu
渁	iiiy
㴇	iiiy
涾	iijg
溑	iimy
㶙	iiog
㶝	iion
漟	iipf
澢	iipl
灙	iipo
㵉	iiss
䣉	iitc
硰	iitd
㲚	iite
㸺	iitg
渻	iith
乷	iitn
鯊	iito
㶃	iito
逤	iitp
桬	iits
潎	iity
㵈	iivd
㴢	iiwh
沝	iiy
渱	ijag
滭	ijag
㵊	ijbc
戦	ijfa
溡	ijff
濹	ijff
浬	ijfg
涆	ijfh
単	ijfj
濐	ijfj
鼝	ijgc
淏	ijgd
淂	ijgf
泹	ijgg
淵	ijgg
浉	ijgh
湜	ijgh
盪	ijgl
燙	ijgo
湯	ijgr
璗	ijgy
㴘	ijhg
滉	ijiq
虩	ijiw
淐	ijjg
澷	ijly
湡	ijmy
洩	ijnt
㵃	ijpx
㵣	ijqw
渇	ijqx
巣	ijsu
淉	ijsy
湦	ijtg
㵆	ijtk
灦	ijxm
濕	ijxo
㶞	ijye
灗	ijyg
澋	ijyi
灝	ijym
渂	ijyy
湒	ikbg
濈	ikby
浥	ikcn
呇	ikf
洖	ikgd
塣	ikgf
浧	ikgg
汌	ikh
沖	ikhh
潰	ikhm
瀢	ikhp
潬	ikkf
澏	ikkm
湂	ikkn
涢	ikmy
溳	ikmy
況	ikqn
㳏	ikry
㳭	iksy
㕾	ikxb
漍	ilag
潩	ilaw
瀱	ildj
潈	iley
泴	ilf
畄	ilf
畓	ilf
澤	ilff
濖	ilfj
潶	ilfo
沺	ilg
㳑	ilg
獣	ilgd
渨	ilge
澴	ilge
㶎	ilgp
㳌	ilh
㶔	illd
灅	illf
㶟	illi
㵽	illl
㵋	ilmy
潿	ilng
㴓	ilny
漣	ilpy
濁	ilqj
聻	ilrb
魙	ilrc
壍	ilrf
䤔	ilrg
漸	ilrh
嬱	ilrv
涃	ilsy
溿	ilug
漊	ilvg
瀭	ilwj
㴅	ilwk
溫	ilwl
㴄	ilwm
溭	ilwt
潀	ilww
濺	imaa
灔	imac
㵹	imad
濃	imae
浀	imag
灎	imal
淟	imaw
䣔	imbh
灧	imdc
漄	imdf
灩	imdl
湠	imdo
灃	imdu
漰	imee
淍	imfk
涄	imgn
溦	imgt
澂	imgt
溰	imgu
㴥	imie
測	imjh
瀃	imjr
潉	imjx
㢢	imka
䣊	imkb
㲂	imkc
尙	imkf
泂	imkg
幤	imkh
瀴	immv
渦	imnk
濄	imnp
漴	impi
溄	imtg
潂	imuo
浻	imwk
汭	imwy
漼	imwy
浿	imy
浵	imye
澱	inac
湣	inaj
尐	inb
淈	inbm
涺	indg
㵤	indw
浘	inen
潳	infj
汈	ingg
泀	ingk
溊	inhc
湑	inhe
沑	inhg
㴮	inie
漽	inig
灟	inij
㳮	iniy
湋	inkg
浺	inkh
澼	inku
瀷	inlw
㲸	inn
潠	innw
瀈	inpl
漝	inrg
湉	intd
㳴	intf
㴵	intl
㶜	inuj
泦	invn
漻	inwe
䀊	inwl
決	inwy
埿	inxf
濢	inyf
瀥	inyk
浕	inyu
泤	inyw
沢	inyy
㵂	ioao
瀇	ioaw
㶋	ioeg
灋	iogc
㴴	iogn
瀍	iojf
澇	iooe
濴	iooi
瀠	iooi
㶈	iooj
瀯	iook
濙	iooo
灐	iooq
濚	ioos
瀅	iooy
㴹	iopy
潾	ioqg
灖	iosd
㲿	iot
灇	iouc
澲	iouf
濧	iouf
㴑	iout
溇	iovg
滽	iovh
漮	iovi
㶐	iown
瀌	ioxo
洣	ioy
瀽	ipah
龸	ipb
敩	ipbt
浤	ipdc
瀗	ipdn
涋	ipdy
瀉	ipeo
㵼	ipeo
労	iper
滱	ipfc
溕	ipfe
坣	ipff
濱	ipgm
漃	iphc
覚	iphq
㵓	ipjh
蛍	ipju
䣘	ipkb
䣣	ipkb
甞	ipkf
䟫	ipkh
劏	ipkj
嘗	ipkj
営	ipkk
㴦	ipkk
當	ipkl
賞	ipkm
㦂	ipkn
黨	ipko
㗬	ipkq
牚	ipkt
瓽	ipky
㼕	ipky
㽆	ipky
渾	iplh
峃	ipmj
澝	ipne
㵳	ipne
㵥	ipnl
滵	ipnm
濵	ipnm
濘	ipns
淧	ipnt
涴	ipqb
鸴	ipqg
鴬	ipqo
栄	ipsu
浨	ipsy
浶	iptg
瀋	iptl
濅	ipvc
洝	ipvg
涳	ipwa
湥	ipwd
浫	ipwf
漥	ipwf
潌	ipwf
㴏	ipwg
㴭	ipwh
㴼	ipwj
滘	ipwk
㵠	ipwm
㴱	ipwu
泬	ipwy
溛	ipwy
㴶	ipwy
涽	iqaj
汦	iqan
泜	iqay
沒	iqcy
洈	iqdb
淊	iqeg
澥	iqeg
澛	iqgj
滐	iqgs
沵	iqiy
潒	iqke
泃	iqkg
洺	iqkg
瀺	iqky
渙	iqmd
瀂	iqoj
㶍	iqou
淗	iqoy
溩	iqoy
漁	iqoy
䳤	iqoy
濥	iqpw
洶	iqrb
㳷	iqrj
淴	iqrn
沕	iqrt
汮	iqug
浄	iqvh
㴔	iqvn
盜	iqwl
㳄	iqwy
渹	iqyg
瀏	iqyj
汋	iqyy
汣	iqyy
汳	ircy
泒	ircy
滜	irdf
垽	irff
㳋	irg
洉	irgk
㴲	irhw
沠	irhy
湶	iriy
淿	irmh
㴈	irmh
峾	irmj
滊	iroy
㝸	irqb
溾	irqc
㵿	irrr
㳺	irtb
渒	irtf
澔	irtk
溵	irvc
湁	irwk
漑	irxq
濼	irxs
㲼	iry
泝	iryy
㶚	isae
㶇	isaw
㴿	isdm
涁	iset
溎	isff
㵱	isff
渿	isfi
泍	isgg
㳹	isgg
涷	isjg
溂	iskj
滒	iskk
瀨	iskm
瀬	iskm
潄	iskt
湅	islg
洓	ismn
㳐	isnn
潥	isoy
湐	isrg
漜	issf
濋	issh
澿	issi
澘	issj
潹	isss
滼	issy
灪	iste
㜑	isvf
㴗	isvg
瀒	iswk
淶	isww
㴤	isyg
汑	itan
澨	itaw
㳵	itbg
㵇	itdf
浲	itdh
潪	itdj
㳢	itdj
漨	itdp
獘	itdu
毟	iteb
㴙	itfe
汘	itfh
汻	itfh
濳	itfj
灒	itfm
涏	itfp
鍌	itfq
涶	itfa
湩	itgf
泩	itgg
湰	itgg
㵲	itgg
汼	itgh
淛	itgj
潕	itgo
洐	itgs
斃	itgx
泆	itgy
潅	itgy
泎	ithf
漇	ithh
沜	ithn
㴧	ithn
䚇	ithq
㴪	iths
乑	ithy
㼳	ithy
暼	itjf
㴡	itjg
浰	itjh
漡	itjr
蟞	itju
鄨	itkc
渪	itky
潨	itli
漗	itln
㴬	itmf
幣	itmh
澚	itmn
瀓	itmt
㵟	itmt
溮	itnh
㳬	itnh
泲	itnt
㴽	iton
㵞	iton
鐅	itqf
鱉	itqo
鷩	itqo
䲵	itqo
㝹	itqy
㵺	itrf
㵌	itrh
撆	itrj
涐	itry
㶘	itsj
潃	itte
澓	ittt
龞	ittx
泘	ituf
㶕	ituj
瀊	itul
溗	itux
泈	ituy
洀	ituy
瀄	itvb
嫳	itvf
涹	itvg
潷	itvg
漎	itwh
潻	itwi
瀩	itwm
䨆	itwy
彆	itxb
塰	itxf
鼈	itxf
瀿	itxi
䌘	itxi
湚	itxn
汷	ity
㳊	ity
溠	iuag
洴	iuah
渆	iuaj
㴊	iubj
㶒	iuco
㳕	iudg
渕	iudj
浂	iudy
瀧	iued
湇	iueg
㵎	iueg
澻	iuep
㴚	iuey
㳆	iufh
淃	iugb
渼	iugd
潤	iugg
漛	iugi
潫	iugi
溔	iugo
瀁	iugv
㵪	iugw
湵	iugy
㳯	iuh
湆	iujg
澗	iujg
灨	iujm
滝	iujn
澺	iujn
滰	iujq
滾	iuke
灛	iukf
涚	iukq
渷	iukq
潧	iulj
溬	iunc
㳾	iunn
㵍	iuny
湴	iuog
潽	iuoj
㶄	iuqe
澬	iuqm
灁	iuri
滧	iurt
洨	iury
澊	iusf
湭	iusg
瀾	iusl
瀙	iusq
澵	iusr
澖	iusy
濶	iutd
滻	iutg
渞	iuth
浐	iutt
濓	iutw
㵛	iuuk
灍	iuuw
淁	iuvg
溓	iuvw
㴸	iuwy
濨	iuxn
潣	iuyy
潯	ivaf
㴌	ivdg
澅	ivfg
㳃	ivfh
潚	ivfj
堻	ivgf
湽	ivgl
湕	ivgp
㳨	ivgq
濜	ivhl
㴋	ivhw
㓥	ivjh
漅	ivjs
㴩	ivkc
㵖	ivki
㖳	ivkx
灉	ivky
氿	ivn
㴆	ivph
㴫	ivtb
涒	ivtk
泿	ivy
澀	ivyh
涊	ivyn
汍	ivyy
㲽	ivyy
浌	iway
滃	iwcn
㳂	iwcy
洑	iwdy
䰪	iwec
洕	iweg
鹡	iweg
鶺	iweo
沴	iwet
漈	iwfi
涻	iwfk
溌	iwfq
泭	iwfy
淪	iwga
渰	iwga
㵸	iwga
潊	iwgc
湀	iwgd
塗	iwgf
㽏	iwgf
洤	iwgg
澮	iwgj
鼡	iwgj
潝	iwgn
㵯	iwgo
洬	iwgq
漵	iwgt
瀲	iwgt
澰	iwgw
㶑	iwgw
滫	iwhe
滺	iwhn
㶖	iwho
滌	iwhs
浟	iwht
㳞	iwkh
涗	iwkq
湺	iwks
㲹	iwn
㵚	iwrq
沨	iwry
㳇	iwry
㳜	iwsy
㳝	iwtf
渢	iwtj
氼	iwu
涖	iwug
洢	iwvt
溣	iwwa
瀸	iwwg
潑	iwxc
沎	iwxn
汃	iwy
汄	iwy
準	iwyf
蠽	iwyj
浛	iwyk
滄	iwyk
盕	iwyl
㵅	iwym
汵	iwyn
淰	iwyn
潐	iwyo
潗	iwys
湌	iwyv
汎	iwyy
渳	ixbg
漲	ixde
泑	ixet
湪	ixey
澠	ixg
瀰	ixgr
淥	ixiy
㵒	ixjm
漒	ixkj
㳽	ixti
濰	ixwy
沘	ixxn
湝	ixxr
漷	iybb
涥	iybh
潡	iybt
㳰	iyca
淯	iyce
㳘	iycq
㳿	iycs
瑬	iycy
㵝	iyek
灜	iyey
㳖	iyey
㶆	iyfj
乼	iygn
㗟	iygx
涼	iyiy
済	iyjg
湻	iyjg
濟	iyjg
滖	iyke
瀼	iyke
瀤	iyle
澟	iylt
滈	iymk
㴜	iyna
滬	iync
涙	iynd
淚	iynd
㴃	iyni
汒	iynn
淭	iyns
㴒	iyoa
湙	iyod
洂	iyoy
渟	iyps
湸	iypw
灕	iyry
汸	iyt
湤	iytb
㵀	iytd
滸	iytf
溈	iyto
㶛	iytw
㡀	iyty
渧	iyuh
滳	iyuk
滀	iyxl
灤	iyxs
灣	iyxx
澭	iyxy
暱	jaak
蠂	jaas
䗃	jaay
昻	jabj
蠎	jada
㬒	jada
昮	jaer
曄	jagg
曅	jagg
䖱	jagg
畢	jagk
鷝	jago
㪤	jagt
㫒	jaj
暯	jajd
䗶	jajn
蝘	jajv
蠇	jajy
暵	jakg
螼	jakg
曣	jako
蠸	jaky
㬮	jaky
蠴	jalj
暎	jamd
蝧	jamd
曂	jamw
蜹	jamw
暪	jamy
蟎	jamy
昛	jang
蚷	jang
煚	jano
曚	jape
螮	jaqh
曔	jaqt
蠮	jatn
蠨	javj
蟏	javw
㿺	jawb
㬦	jawc
晎	jawy
謈	jawy
朂	jber
㫗	jbf
虸	jbg
㫞	jbhc
蜬	jbib
蟶	jbkg
曓	jbmf
昢	jbmh
䖦	jbmh
㬧	jbmi
㬥	jbmo
虵	jbn
蚾	jby
昅	jbyy
昪	jcaj
蝃	jccc
㬃	jcko
䝨	jcmu
蚆	jcn
蝚	jcns
螞	jcoy
晙	jcwt
䘈	jdae
曞	jday
蠣	jday
蚅	jdbn
蛂	jdcy
蛕	jdeg
䗅	jdey
蜄	jdfe
晇	jdfn
鷐	jdfo
㬄	jdfo
䖨	jdg
蟵	jdgf
蝛	jdgv
蚽	jdhg
䗩	jdhi
㬩	jdhn
暳	jdhv
蛨	jdjg
昦	jdjj
晻	jdjn
蝒	jdlf
蝡	jdmd
㬉	jdmd
暊	jdmy
蝢	jdmy
晠	jdnn
蚘	jdny
蛖	jdny
䗮	jdrr
䗁	jdsk
旲	jdu
暸	jdui
蟟	jdui
蟩	jduw
蜯	jdwg
暙	jdwj
蟖	jdwr
蛺	jdww
昽	jdxy
㦔	jedn
猒	jedy
蛠	jeee
冐	jef
蛶	jefy
蚏	jeg
蝯	jegc
㬊	jegc
勗	jege
琞	jegy
㬭	jelf
焽	jeou
曌	jepa
曖	jept
晲	jeqn
蜺	jeqn
䳟	jeqo
㿢	jerf
㫑	jet
暚	jetb
蟡	jeto
㬙	jeto
螇	jexd
䘂	jfag
蟦	jfam
暁	jfaq
蠘	jfay
䖼	jfcb
蜐	jfce
䗘	jfcl
蚑	jfcy
㫢	jfcy
曘	jfdj
黙	jfdo
圼	jff
曇	jffc
晆	jffg
曉	jffq
蟯	jffq
㫭	jffu
時	jffy
旪	jfh
虷	jfh
㪋	jfhc
蛣	jfkg
暿	jfkk
蟢	jfkk
暔	jfmf
㬨	jfoo
黒	jfou
㫱	jfou
㫲	jfpb
曀	jfpu
蚖	jfqn
䳚	jfqo
䗋	jfsy
㫴	jftb
暏	jftj
蝫	jftj
螧	jftj
蛯	jftx
蟽	jfup
㬡	jfwc
䗀	jfwt
曤	jfwy
䖞	jfy
蚈	jgah
旽	jgbn
晊	jgcf
䖶	jgey
旴	jgfh
虶	jgfh
㝵	jgfu
蚟	jgg
昰	jghf
韙	jghg
㓳	jghj
題	jghm
鶗	jgho
䗡	jgho
遈	jghp
尟	jght
晸	jght
㼵	jghy
蛷	jgiy
暷	jgjf
晅	jgjg
螎	jgkh
㬏	jgkh
䗖	jgkh
曧	jgkj
鼌	jgkn
䗵	jglg
昁	jgmh
昞	jgmw
昺	jgmw
蛃	jgmw
曬	jgmx
蜽	jgmy
㫫	jgof
㬐	jgoj
㦹	jgqa
㫕	jgqb
蛚	jgqj
䬗	jgqj
鴠	jgqo
逿	jgqp
昜	jgqr
敭	jgqt
昩	jgsy
蚲	jguf
蛵	jgva
蜨	jgvh
㫸	jgvh
鼂	jgxf
螦	jgxi
蛦	jgxw
蝳	jgxy
㫙	jgy
暃	jhdd
㫵	jhdd
毷	jhen
㫔	jhf
蝆	jhgf
䖹	jhgf
㪞	jhhc
蠷	jhhy
㬬	jhhy
晫	jhjh
暢	jhjr
蛅	jhkg
曥	jhll
蠦	jhll
迧	jhpk
㒻	jhqb
晛	jhqn
蜆	jhqn
畃	jhqy
朄	jhsl
䗂	jhwn
蟕	jhxe
虲	jhy
蟝	jias
晄	jigq
㫾	jimk
蟐	jiph
蟷	jipl
曭	jipo
䖢	jitt
蝋	jiwg
㬁	jiwk
晘	jjfh
昍	jjg
蚎	jjg
蜵	jjgg
㫜	jjgg
䖧	jjgg
蝭	jjgh
㫯	jjgq
暘	jjgr
蝪	jjgr
蝐	jjhg
曑	jjje
曟	jjje
晿	jjjg
曐	jjjg
曡	jjjg
䗉	jjjg
蠱	jjjl
蝿	jjjn
蟲	jjju
㬪	jjjx
蟃	jjlc
蝹	jjlg
㬈	jjlg
㬂	jjmy
㫣	jjnb
焸	jjou
暥	jjpv
暍	jjqn
晹	jjqr
蠍	jjqw
㫀	jjrh
暒	jjtg
䗌	jjtg
䗑	jjug
㬤	jjxo
䗾	jjxo
蜫	jjxx
䖵	jjy
暻	jjyi
蜎	jkeg
冔	jkgf
蚛	jkhh
暺	jkkf
蟬	jkkf
䗭	jkkn
曮	jkkt
㫛	jkqn
蟈	jlag
鄤	jlcb
蝟	jleg
昷	jlf
曎	jlff
蠌	jlff
䘃	jlff
蟔	jlfo
蠉	jlge
蛼	jlh
䖬	jlh
蜖	jljf
蠝	jlll
蠋	jlqj
螹	jlrh
㼔	jlry
蜠	jlty
螻	jlvg
曪	jlxy
㬅	jlyr
晪	jmaw
螖	jmeg
蚦	jmfg
晭	jmfk
晍	jmgk
暟	jmgu
螘	jmgu
顒	jmhm
颙	jmhm
㼴	jmhy
旵	jmj
㬞	jmjn
蠳	jmmv
蝸	jmnk
蛧	jmrr
蝄	jmun
蠵	jmwk
蛽	jmy
蚒	jmyg
㬆	jnaj
蜛	jndg
毾	jnen
蛡	jng
暅	jngg
蝦	jnhc
蝑	jnhe
丱	jnhg
蝞	jnhg
䖡	jnhg
虯	jnhh
曯	jnij
蠾	jnij
暐	jnkg
蟤	jnnw
旸	jnrt
䖩	jntt
曵	jnty
蟉	jnwe
㬔	jnwe
蚗	jnwy
蠗	jnwy
蚭	jnxn
蚇	jnyy
蟅	joao
曠	joaw
昿	jocy
顕	jodm
蟧	jooe
蠑	joos
晱	jooy
䗊	jooy
暽	joqg
䗲	joqg
䗫	joss
㫧	jou
曗	jouf
㬣	jouf
䗱	joug
蝷	jout
䗤	jovh
䗧	jovi
㷖	jovk
螰	joxx
炚	joy
曢	jpdi
螛	jpdk
䘆	jpdn
晥	jpfq
䖾	jpfq
蝖	jpgg
蝊	jpgh
蠙	jpgm
螾	jpgw
暉	jplh
暈	jplj
䗆	jpng
䗿	jpns
䗏	jpoc
晼	jpqb
䖳	jpta
㫨	jpvg
鷃	jpvo
䨃	jpvy
螲	jpwf
㬕	jpyu
蚔	jqan
蚳	jqay
㫝	jqay
蛫	jqdb
㬗	jqdo
曕	jqdy
蜭	jqeg
蠏	jqeg
曻	jqgj
晀	jqiy
䖴	jqiy
㫬	jqjg
䖲	jqjg
昫	jqkg
蚼	jqkg
㫥	jqkg
晩	jqjq
蜔	jqlg
㬇	jqmd
蝜	jqmy
蚫	jqnn
螐	jqoy
䗇	jqoy
䗨	jqoy
䳋	jqoy
蛥	jqqy
敡	jqrc
惖	jqrn
䗓	jqrn
鶍	jqro
逷	jqrp
昒	jqrt
蟂	jqsy
蜪	jqtb
蚐	jqug
㬠	jqvo
毼	jqwe
㔠	jqwe
鹖	jqwg
㓭	jqwj
䫘	jqwm
鶡	jqwo
欥	jqwy
㰩	jqwy
䗜	jqyl
旳	jqyy
虳	jqyy
蝬	jrbt
昄	jrcy
蛌	jrcy
暤	jrdf
晞	jrdh
䖷	jrdh
䖰	jrey
蚚	jrh
螔	jrhw
䖣	jrhy
暭	jrif
㫹	jrnr
暣	jroy
螝	jrqc
晣	jrrh
曒	jryt
蚸	jryy
顆	jsdm
褁	jseu
䗎	jsfg
㬓	jsfi
㬍	jsfy
䗚	jsfy
㼫	jsgy
虰	jsh
敤	jshc
蝀	jsjg
曋	jsjh
蟫	jsjh
蝲	jskj
暕	jslg
晽	jssy
㪙	jsty
蜙	jswc
蚞	jsy
蜅	jsy
昇	jtaj
虴	jtan
蜏	jtbt
蟜	jtdk
䗦	jtdp
旿	jtfh
晧	jtfk
䗢	jtfp
䗗	jtga
蝩	jtgf
甠	jtgg
﨡	jtgg
㫼	jtgj
蟱	jtgo
䗼	jtgo
昳	jtgy
蛈	jtgy
蝂	jthc
螑	jthd
曍	jthf
暞	jths
蟍	jtjs
蛒	jtkg
蝺	jtky
蟌	jtln
䘊	jtlw
螕	jtlx
晑	jtmk
䖮	jtmk
蜁	jtnh
螄	jtnh
㫓	jtnn
䗴	jttp
㫡	jtuu
昸	jtuy
䗻	jtvb
蜲	jtvg
暰	jtwh
䗥	jtwh
暀	jtyg
㧛	jtyr
䛓	jtyy
暛	juag
蛢	juah
曨	jued
蠬	jued
㒽	jugb
㫠	jugh
蟻	jugy
㬢	jugy
曈	jujf
暲	jujh
䗷	jujn
㬝	julj
䗒	juog
䝉	jupe
蠀	juqm
晈	jury
螏	jutd
昗	juu
螊	juvw
螠	juwl
䗹	juxn
晜	juxt
螆	juxx
蟳	jvaf
蝍	jvbh
妟	jvf
蟰	jvfj
㬘	jvfj
曃	jvip
㫽	jviy
蛁	jvkg
蠟	jvln
帰	jvph
㫶	jvph
螁	jvpy
䳛	jvqo
旫	jvt
虭	jvt
蛝	jvy
蟘	jwam
蚮	jway
暡	jwcn
螉	jwcn
昖	jwcy
昣	jwet
䖫	jwfh
暩	jwfi
蚹	jwfy
蜦	jwga
㫻	jwga
㬛	jwgn
䗳	jwgu
䗛	jwhe
螩	jwhs
㬰	jwi
㫟	jwkg
蛻	jwkq
㬋	jwnd
䗔	jwnd
䗄	jwrr
蚥	jwry
昐	jwvt
蚡	jwvt
蛜	jwvt
䘋	jwwg
昤	jwyc
蠄	jwyc
蜼	jwyg
㫿	jwyg
蛿	jwyk
螥	jwyk
昑	jwyn
蚙	jwyn
蟭	jwyo
䗯	jwyp
䖠	jwyy
㫐	jxb
蝝	jxey
蠅	jxg
昲	jxjh
曊	jxjm
䗰	jxmy
曏	jxtb
蜌	jxxf
鹍	jxxg
顯	jxxm
鵾	jxxo
㬎	jxxo
蝔	jxxr
歞	jxxw
蟣	jxxw
㬑	jybb
蜳	jybg
㬀	jybg
蜟	jyce
䖻	jyck
㬚	jyct
㬯	jyey
蠩	jyfj
㔀	jyij
䯫	jyik
顥	jyim
蠐	jyjg
㬌	jyji
蠰	jyke
蟺	jylg
暠	jymk
蜧	jynd
䗈	jynh
昹	jyni
㫤	jyni
㬖	jynk
昈	jynt
晐	jynw
蠔	jype
蝏	jyps
昘	jyr
㒿	jyry
昉	jyt
蚄	jyt
暆	jytb
㒾	jytb
暶	jyth
旻	jyu
蟙	jyuj
螪	jyuk
蜋	jyvy
㫰	jyvy
晬	jywf
蜶	jywf
蚢	jywn
䘎	jyxx
昡	jyxy
蚿	jyxy
旼	jyy
㖑	kaah
㘕	kaal
㘃	kadn
囈	kafc
嚡	kaff
㗆	kafh
㗾	kafx
叿	kag
嘩	kagg
嚂	kahl
㘋	kahm
囕	kahq
嗼	kajd
唶	kajg
囆	kajj
噧	kajy
嘆	kakg
㖪	kakg
嘔	kakk
嚥	kako
嚾	kaky
㗕	kamf
唝	kamy
嗊	kamy
呭	kann
㗣	kaqh
噆	kaqj
㖴	kaqr
囌	kaqt
囒	kaul
嚄	kawc
嚿	kawe
嗏	kaws
囁	kbbb
㖿	kbbh
㖩	kbcy
唨	kbeg
咠	kbf
吇	kbg
咡	kbg
㖤	kbib
吔	kbn
㗦	kbqb
嘇	kcce
㗈	kcee
䣈	kckc
咍	kckg
噊	kcnk
㖻	kcns
㘐	kcor
嗎	kcoy
咗	kdag
㗞	kdby
吰	kdcy
㕹	kdcy
嘠	kdea
喐	kdeb
哊	kdeg
㗅	kdeg
嚘	kdet
喯	kdfa
㖘	kdfe
啀	kdff
嗕	kdff
㖠	kdfi
咵	kdfn
㖅	kdgg
喴	kdgv
囓	kdhb
喫	kdhd
㕩	kdhh
㗏	kdhh
噄	kdhi
嚖	kdhn
嘒	kdhv
吥	kdhy
嚈	kdjd
咟	kdjg
唵	kdjn
喕	kdlf
咘	kdmh
㖇	kdmj
順	kdmy
㖽	kdmy
哤	kdny
㕱	kdny
嚦	kdth
㕦	kdu
㖺	kdwj
啿	kdwn
唊	kdww
唭	kdwy
㗐	kdyl
哹	kebg
啂	kebn
㖬	kecy
嗋	keee
㗖	keeg
肙	kef
哷	kefy
喛	kegc
瓹	kegy
剈	kejh
㗎	keks
㕰	ken
㘀	keoy
㖟	kepc
噯	kept
唲	keqn
鵑	keqo
㗗	kerf
啋	kesy
嗂	ketb
噅	keto
哸	kevg
嗘	kexd
噴	kfam
哋	kfbn
呍	kfcy
呿	kfcy
啩	kffh
㘑	kffi
嘵	kffq
咁	kfg
唗	kfhy
呩	kfiy
㘆	kfkf
啚	kflk
嚋	kfnf
嚇	kfoo
哱	kfpb
嚔	kfph
㖼	kfsy
啫	kftj
嘋	kftt
咾	kftx
啈	kfuf
噠	kfup
㖫	kfwt
吋	kfy
㘊	kfyg
咞	kgah
哢	kgah
噸	kgbm
咥	kgcf
㗺	kgdd
啨	kgeg
啞	kgfg
噁	kgfn
㕵	kgg
㕶	kgg
噖	kggn
嘕	kgho
咺	kgjg
唖	kgkg
哣	kgku
唡	kgmw
囇	kgmx
啢	kgmy
嘖	kgmy
㙱	kgnf
鸮	kgng
䪽	kgnm
鴞	kgno
飸	kgnv
號	kgnw
咓	kgny
嚽	kgqm
呯	kguf
啑	kgvh
啛	kgvv
踐	khaa
䠜	khab
㖸	khag
蹛	khah
踖	khaj
躤	khaj
蹃	khak
跇	khan
䟠	khan
䟙	khav
蹣	khay
躪	khay
䠰	khay
躡	khbb
踙	khbc
嚙	khbh
䠫	khbi
踂	khbn
跥	khbs
䟾	khcc
踴	khce
䠁	khcf
蹫	khck
跁	khcn
踆	khct
䟥	khct
㕜	khcu
䟕	khcy
蹖	khde
䟴	khde
䠆	khde
䠒	khde
䠑	khdf
跍	khdg
噦	khdh
蹽	khdi
䠞	khdi
踳	khdj
踎	khdk
踦	khdk
踸	khdn
跶	khdp
踑	khdw
䠛	kheb
䟹	khef
跀	kheg
跙	kheg
⻊	khf
踋	khfb
踍	khfb
跂	khfc
䟩	khfc
跱	khff
踛	khff
躊	khff
跿	khfh
踷	khfj
䟚	khfj
躂	khfp
蹺	khfq
踜	khft
蹎	khfw
跊	khfy
嚱	khga
踁	khga
䣒	khgb
囐	khgd
哶	khgf
趶	khgf
跮	khgf
踕	khgh
䟛	khgh
蹧	khgj
㘌	khgj
踾	khgl
貴	khgm
蹟	khgm
䫭	khgm
遺	khgp
躎	khgr
跠	khgw
躧	khgx
䟵	khgy
䟼	khgy
䠃	khgy
踧	khhc
躩	khhc
䠊	khhd
䠐	khhd
躆	khhe
䠡	khhg
踄	khhh
䠩	khhh
跕	khhk
嚬	khhm
䠕	khhs
跐	khhx
躣	khhy
㘗	khhy
䟔	khhy
踃	khie
蹐	khie
䠌	khie
蹚	khif
䠀	khik
䟞	khit
䠥	khit
噓	khjg
蹕	khjg
啅	khjh
踶	khjh
踼	khjr
跩	khjt
噳	khkd
䠤	khkf
呫	khkg
踀	khkh
蹪	khkm
䠝	khkm
䟧	khlg
嚧	khll
蹥	khlp
䠅	khlt
䟖	khmh
踻	khmk
䟜	khmw
䠄	khmw
䟺	khmy
䟨	khna
䠍	khnc
䟳	khnd
蹍	khne
蹘	khne
䠎	khnf
䠧	khnj
䠱	khnj
跼	khnk
䠇	khnm
䟤	khnt
躃	khnu
趹	khnw
䠣	khnw
跜	khnx
躍	khny
噛	khob
躕	khof
蹸	khog
蹠	khoo
蹗	khox
踠	khpb
蹜	khpj
迚	khpk
躥	khpn
䠉	khpn
䠚	khpy
䟗	khqa
䟸	khqa
踭	khqh
䟢	khqi
跔	khqk
蹓	khql
哯	khqn
踘	khqo
蹨	khqo
跢	khqq
䟡	khqy
䠨	khqy
䠋	khrf
䟬	khrg
踲	khrh
躓	khrm
䟷	khrr
躒	khrs
躈	khrt
蹏	khrw
跅	khry
跴	khsg
蹅	khsg
䟓	khsh
跒	khsk
踈	khsk
䟱	khsm
䠭	khsm
蹮	khsn
躚	khsp
䟣	khsy
䟦	khtc
䟯	khtd
䠗	khtd
嘑	khtf
跦	khtf
䟭	khtf
跭	khtg
躌	khtg
蹝	khth
蹤	khth
䠦	khtj
蹻	khtk
躦	khtm
趷	khtn
踿	khto
鷺	khto
䟪	khtp
䟰	khts
踒	khtv
踇	khtx
䠘	khtx
跰	khua
踡	khub
躑	khub
躘	khud
䠔	khue
蹡	khuf
蹱	khuf
跘	khug
䠓	khug
䠖	khuk
躝	khul
躢	khun
踫	khuo
䠮	khuo
躨	khut
踥	khuv
躙	khuy
䟿	khvi
䠈	khvi
蹆	khvp
踚	khwa
䠯	khwa
䠬	khwb
跉	khwc
蹳	khwc
䟝	khwc
䟮	khwd
䠏	khwd
跈	khwe
䟶	khwf
跧	khwg
踨	khwh
踰	khwj
跲	khwk
蹌	khwk
趻	khwn
踗	khwn
蹹	khwn
䟻	khws
踓	khwy
㖵	khwy
躖	khxh
㗪	khxi
蹞	khxm
躀	khxm
䠪	khxn
喍	khxs
蹢	khyd
躟	khye
踤	khyf
跓	khyg
躋	khyj
䟽	khyk
跡	khyo
䟲	khyq
趽	khyt
蹾	khyt
䟘	khyw
㗔	khyy
䠙	khyy
嘙	kibv
唦	kiit
嗩	kimy
嘡	kipf
嚐	kipj
噹	kipl
㗂	kith
㘍	kiwa
嗶	kjag
嚗	kjai
㖏	kjfg
嘢	kjfh
哻	kjfh
呾	kjgg
㖷	kjgh
啺	kjgr
嗢	kjlg
㖂	kjnt
嗮	kjsg
喅	kjug
雖	kjwy
噐	kkak
嚚	kkak
郘	kkbh
唈	kkcn
駡	kkco
嚻	kkdk
囂	kkdk
嚴	kkdt
哵	kkej
卾	kkfb
㓵	kkfj
顎	kkfm
咢	kkfn
鶚	kkfo
遌	kkfp
覨	kkfq
吅	kkg
呺	kkgn
㕺	kkgn
嘳	kkhm
哫	kkhy
戰	kkja
鄲	kkjb
囅	kkje
辴	kkje
單	kkjf
丳	kkjk
鷤	kkjo
鄵	kkkb
碞	kkkd
氉	kkke
嘽	kkkf
劋	kkkj
㗊	kkkk
喦	kkkm
嵒	kkkm
㗁	kkkn
喿	kkks
㘙	kkkt
獸	kkld
㽞	kklf
嘼	kklk
鼉	kklx
㖞	kkmw
嘂	kknk
斝	kkpf
䑝	kkpg
呪	kkqn
䣞	kkub
遻	kkup
㖾	kkut
㖐	kkvt
呮	kkwy
喌	kkyh
嘓	klag
嚜	klff
㘁	klff
嚸	klfk
呬	klg
噮	klge
囀	klgf
啯	klgy
唓	klh
嚃	klip
嘪	klmy
嗹	klpy
噣	klqj
啰	klqy
㖥	klty
嚺	klup
嘍	klvg
囉	klxy
㗄	klyt
噥	kmae
㖆	kmag
翤	kman
唺	kmaw
鄖	kmbh
嘊	kmdf
啱	kmdg
䫟	kmdm
咉	kmdy
嗗	kmeg
勛	kmet
呥	kmfg
哃	kmgk
䚋	kmhq
嚶	kmmv
喎	kmnk
㗻	kmnp
鶰	kmqo
吶	kmty
員	kmu
囎	kmuj
㖗	kmwn
嗺	kmwy
㗀	kmxx
唄	kmy
㗃	knaj
呡	knan
啒	knbm
噉	knbt
啹	kndg
吳	kndu
呞	kngk
呉	kngw
㗇	knhc
吜	knhg
囑	knij
喡	knkg
噀	knnw
㗩	knrg
㕧	knt
咇	kntt
嘐	knwe
吷	knwy
嚁	knwy
噿	knyf
㕽	knyw
呎	knyy
喥	koac
嗻	koao
嚝	koaw
㖢	kohx
嘮	kooe
㘇	koos
㗵	koow
噒	koqg
嚰	kosd
嚤	kosr
嚒	kosx
嚉	kouf
㗼	kouf
嘃	kovh
吙	koy
㗷	kpam
㘔	kpam
嗐	kpdk
唍	kpfq
㗌	kpgf
喗	kplh
嚀	kpns
啘	kpqb
㕪	kpqn
哰	kptg
咹	kpvg
啌	kpwa
㗧	kpwf
噾	kpwj
㕴	kpwn
咜	kpxn
㖧	kqaj
呧	kqay
㗙	kqbt
㗋	kqdd
嘫	kqdo
噡	kqdy
嘝	kqef
啗	kqeg
唃	kqeh
唫	kqg
咷	kqiy
咰	kqjg
別	kqjh
呴	kqkg
喣	kqko
㒭	kqkq
嚵	kqky
喚	kqmd
嚕	kqoj
嗚	kqoy
鳴	kqoy
哅	kqrb
㕼	kqrn
嘄	kqsy
唙	kqto
呁	kqug
喼	kqvn
焁	kqwo
嚠	kqyj
㕳	krbh
㖁	krdc
㗑	krdf
唕	krfh
㕷	krg
喤	krgg
㖃	krgk
嗁	krhw
噑	krif
啲	krqy
咑	krsh
唞	kruf
喞	krxb
嚛	krxs
噭	kryt
喖	ksdg
㖶	ksfg
㗘	ksfy
呠	ksgg
唒	ksgg
㖦	ksjg
嘾	ksjh
槑	ksks
㘄	ksly
唽	ksrh
㗚	kssy
喓	ksvg
嘜	kswq
唻	ksww
㕲	ksy
呏	ktah
唀	ktbt
咶	ktdg
㖓	ktdh
嘺	ktdk
㖔	kgdk
㖭	kgdn
㕭	ktdy
喢	ktfe
嚹	ktff
吀	ktfh
吘	ktfh
哠	ktfk
囋	ktfm
咮	ktfy
啣	ktgb
㗢	ktge
喠	ktgf
吽	ktgh
哖	ktgh
嘸	ktgo
嚑	ktgo
哘	ktgs
呹	ktgy
嘷	kthf
嘥	kthh
喒	kthj
嚊	kthj
唌	kthp
嘚	ktjf
㗍	ktjg
唎	ktjh
呂	ktkf
啝	ktkg
囖	ktly
㗓	ktnp
噃	ktol
㗭	kton
嚟	ktqi
㘅	ktqs
㗛	kttd
㗸	ktts
㘉	ktvb
唩	ktvg
㗰	ktwh
㗳	ktwk
呚	kty
咊	kty
叺	ktyy
咲	kud
咲	kudy
嚨	kued
㗴	kueg
呌	kufh
㕸	kug
啳	kugb
㗝	kugo
㖕	kuh
啴	kujf
噇	kujf
噷	kujw
㖣	kukg
哾	kukq
嗴	kunc
唴	kunn
㘚	kunt
㘎	kunt
嚪	kuqe
噂	kusf
㗿	kusk
㘓	kusl
嚫	kusq
噺	kusr
喭	kute
㘖	kutm
嗛	kuvw
唥	kuwc
㘂	kuxn
㖒	kuxt
嗞	kuxx
噚	kvaf
嘅	kvaq
㗲	kvfg
嘯	kvfj
㖊	kvfy
㖀	kvgh
嚍	kvhl
㖨	kviy
嗈	kvkc
㕤	kvn
嘨	kvoj
唚	kvpc
叧	kvr
吚	kvtt
䬭	kvwv
咃	kwbn
吺	kwcy
㕬	kwcy
㘴	kwfd
㗫	kwfi
啽	kwga
㖮	kwga
喩	kwgb
㘛	kwgd
噲	kwgj
噏	kwgn
嗱	kwgr
唋	kwgs
噞	kwgw
㖉	kwhg
吤	kwjh
嗰	kwld
㰨	kwqw
㕮	kwry
哬	kwsk
嘦	kwsv
喺	kwti
㖹	kwvl
唂	kwwk
㗶	kwxc
吪	kwxn
㕥	kwy
唅	kwyk
嗆	kwyk
嗿	kwym
唸	kwyn
㗹	kwyn
鷕	kwyo
㗱	kwys
喰	kwyv
㕨	kwyy
咈	kxjh
㖰	kxmk
喲	kxqy
嚩	kxsf
㘈	kxth
㖎	kxwj
哛	kxwv
噝	kxxi
嘰	kxxw
呣	kxy
㗥	kybb
啍	kybg
噋	kybt
㗒	kyey
噈	kyiy
嚌	kyjg
嗃	kymk
呝	kynn
喨	kypw
囄	kyry
㕫	kyt
㖄	kyth
嗙	kyuy
哴	kyvy
唹	kywu
囃	kywy
㖡	kywy
㗜	kyxl
呟	kyxy
噰	kyxy
呅	kyy
軾	laay
輚	laay
羇	lafk
䡷	lafl
羈	lafo
軭	lagg
轞	lahl
䍓	laht
羃	lajh
轕	lajn
㘟	lak
國	lakg
罭	lakg
㽣	lakg
䡱	lakk
爴	laky
䡸	laln
轥	lauy
異	lawu
輁	lawy
輙	lbcy
䡕	lbig
輒	lbnn
罊	lbwb
礊	lbwd
繫	lbwi
蟿	lbwj
轚	lbwl
擊	lbwr
檕	lbws
畷	lccc
罬	lccc
輟	lccc
㽩	lcce
䡦	lccs
輽	lcdl
㔥	lcee
羆	lceo
罷	lcex
圗	lcff
軽	lcfg
囜	lci
㘝	lci
囼	lckd
軩	lckg
圎	lcmi
㙒	lcnf
輮	lcns
㽥	lcns
罞	lcnt
罵	lcou
㽙	lcqn
畯	lcwt
軛	ldbn
䍔	ldcu
軷	ldcy
䡌	ldcy
軲	ldg
輱	ldgk
轗	ldgn
囨	ldhi
䡺	ldhn
轊	ldhv
㽢	ldjn
盢	ldlf
輭	ldmd
輀	ldmj
罽	ldoj
欭	ldqw
輢	ldsk
轣	ldth
䍥	ldth
轑	ldui
輳	ldwd
䡳	ldwr
轃	ldwt
㽠	ldww
軑	ldy
轪	ldy
軚	ldyy
罦	lebf
㘞	lee
輣	leeg
轁	leeg
㽟	lefy
䢁	leg
罝	legf
軞	len
輗	leqn
㽖	let
䡃	let
㽒	letg
㘥	leti
轒	lfam
囩	lfci
圔	lfcl
転	lfcy
䡋	lfcy
轜	lfdj
㽭	lfdj
罣	lfff
罫	lffh
畤	lffy
軒	lfh
㸃	lfho
䡩	lfhw
団	lfi
䍐	lfj
畊	lfjh
囲	lfjk
園	lfke
瞏	lfke
轅	lfke
䡼	lfkk
䡿	lfkw
䍣	lflf
疇	lfnf
黭	lfoa
黦	lfob
䵥	lfoc
黲	lfoe
黚	lfof
黫	lfof
䵟	lfof
䵢	lfof
䵦	lfof
䵯	lfof
䵣	lfog
䁿	lfoh
䵞	lfoj
䵬	lfoj
䵭	lfoj
䵳	lfoj
點	lfok
黬	lfok
䵱	lfok
黸	lfol
黷	lfom
黗	lfon
黤	lfon
黮	lfon
䵝	lfon
黕	lfoq
黖	lfoq
䵮	lfor
䵰	lfor
䵲	lfos
黰	lfow
㱄	lfow
黣	lfox
䵪	lfox
䵴	lfox
黓	lfoy
黵	lfoy
䵠	lfoy
䵨	lfoy
䡹	lfph
䡇	lfqn
睪	lfuf
鸅	lfuo
斁	lfut
歝	lfuw
轌	lfvg
䡜	lfwf
轖	lfwk
輘	lfwt
軘	lgbn
輊	lgcf
囯	lgd
輤	lgeg
圂	lgei
慁	lgen
軖	lgg
囸	lghd
車	lghh
㓻	lghj
團	lgjf
轉	lgjf
睘	lgke
鹮	lgkg
輻	lgkl
翾	lgkn
䴉	lgko
還	lgkp
疅	lglg
輌	lgmm
輛	lgmy
軏	lgqn
軯	lguf
輕	lgva
鑋	lgvq
䡖	lgwf
畉	lgy
䡍	lgy
軙	lhcy
輫	lhdd
䡾	lhgd
㐃	lhk
轤	lhll
䡠	lhmy
罒	lhng
輎	lieg
塁	liff
輄	ligq
㘢	ligq
囦	lii
䍝	lijf
㘤	lijg
疂	lipg
遝	lipi
䳴	liqo
㱎	liqw
眔	liu
軣	liu
罼	ljag
囬	ljfd
廽	ljfp
逥	ljfp
畼	ljgr
輰	ljgr
䡬	ljlc
輼	ljlg
辒	ljlg
輵	ljqn
輠	ljsy
輥	ljxx
輯	lkbg
㘣	lked
罥	lkef
圖	lkfk
甽	lkh
䡅	lkh
圚	lkhm
䡲	lkkf
圓	lkmi
廻	lkpd
迴	lkpd
軦	lkqn
毄	lkwc
軹	lkwy
䍛	lldf
畕	llf
圛	llff
䡒	llg
轘	llge
䡛	llh
㘡	llk
罍	lllb
奰	llld
礨	llld
氎	llle
㔣	llle
壘	lllf
壨	lllf
畾	lllf
疊	lllg
㽮	lllg
纍	llli
轟	lllj
轠	llll
鸓	lllo
䴎	lllo
櫐	llls
疉	lllx
罳	llnu
轋	llpy
轀	llwl
圐	llye
圌	lmdj
輲	lmdj
軮	lmdy
畘	lmfg
輖	lmfk
軸	lmg
軕	lmh
䚑	lmhq
鷶	lmqo
買	lmu
輞	lmun
㽯	lmwk
軜	lmwy
罠	lnab
輾	lnae
䡑	lnan
囻	lnav
轏	lnbb
囙	lnd
顋	lndm
罻	lnff
軐	lnfh
翈	lng
䡂	lnhh
圍	lnkg
䡶	lnku
軋	lnn
㤙	lnnu
㘠	lnte
疁	lnwe
轇	lnwe
疄	loqg
轔	loqg
䍘	lou
轛	louf
轐	loug
轆	loxx
䍡	loxx
轄	lpdk
畳	lpeg
輐	lpfq
連	lpk
䡣	lplh
輨	lpng
㦁	lpnu
䡝	lpqb
䡥	lpwk
䡐	lpxn
軝	lqan
軧	lqay
䍕	lqay
輡	lqeg
㝶	lqfu
斀	lqjc
斣	lqjf
劅	lqjj
䫳	lqjm
鸀	lqjo
歜	lqjw
軥	lqkg
㽛	lqkg
輓	lqkq
䡘	lqlg
䍖	lqnb
軳	lqnn
鴨	lqoy
鴫	lqoy
㽤	lqoy
䡧	lqoy
䡔	lqqy
畇	lqug
軟	lqwy
輷	lqyg
罶	lqyl
畂	lqyy
䍟	lrbt
畖	lrcy
罛	lrcy
軱	lrcy
䡊	lrcy
磛	lrdf
塹	lrff
輴	lrfh
䟅	lrfh
斬	lrh
覱	lrhq
暫	lrjf
蹔	lrkh
㟻	lrmj
慙	lrnu
鏨	lrqf
䡚	lrqn
䳻	lrqo
㨻	lrrj
䡈	lrry
槧	lrsu
㽡	lrtf
䡟	lrtf
㜞	lrvf
䭕	lrwv
轢	lrxs
圑	lsfi
輏	lsgg
甼	lsj
軻	lskg
罧	lssu
䍒	lsu
輔	lsy
轎	ltdk
䡫	ltdp
軠	ltfg
䡽	ltfm
畽	ltgf
輧	ltgf
㽚	ltgj
䍢	ltgo
軼	ltgy
䡻	lthy
囷	lti
輹	ltjt
畧	ltkf
輅	ltkg
䌎	ltki
㨼	ltkr
䡯	ltln
䢀	ltnn
轓	ltol
軤	ltuf
輈	ltuy
辀	ltuy
䡮	ltwh
䍙	ltxu
畮	ltxy
㽨	luag
軿	luah
䡵	luep
䢂	lug
畻	lugf
圏	lugn
轙	lugy
罯	lujf
罿	lujf
䡴	lujf
㽪	lulj
䡭	lung
図	luri
較	lury
輶	lusg
罤	luxt
㽧	luxx
䣚	lvbh
䫫	lvdm
氀	lven
婁	lvf
㚻	lvf
圕	lvfj
輺	lvgl
甊	lvgy
罺	lvjs
轈	lvjs
軺	lvkg
輜	lvlg
軌	lvn
遱	lvpd
鷜	lvqo
輑	lvtk
數	lvty
㪹	lvuf
軔	lvyy
繋	lwci
撃	lwcr
軗	lwcy
䡆	lwcy
圙	lwdf
軫	lwet
囶	lwfd
軵	lwfy
圇	lwga
輪	lwga
輇	lwgg
輸	lwgj
畭	lwgs
畍	lwjh
朙	lwme
囧	lwmv
䡄	lwn
畟	lwtu
輍	lwwk
眾	lwww
囮	lwxv
㽗	lwy
軨	lwyc
圀	lwye
䍜	lwyf
軡	lwyn
罖	lwyu
軓	lwyy
䡏	lxcy
軪	lxet
羄	lxhj
羂	lxke
邏	lxwp
羅	lxwy
毘	lxxb
䡡	lxxr
轍	lyct
圁	lyd
畩	lyey
罸	lyfu
罜	lygf
軴	lygg
輬	lyiy
辌	lyiy
䍤	lyjf
罰	lyjj
䡢	lyna
甿	lynn
軶	lynn
䡪	lynn
䡎	lynt
畡	lynw
輆	lynw
䍠	lyrc
䍦	lyry
䍚	lyvu
䡙	lyvy
㽘	lywn
䡉	lywn
囥	lywv
羉	lyxi
圞	lyxs
䍗	lyxu
圝	lyxx
贜	maah
賤	maay
㟞	maay
㟿	mada
農	made
蠈	madj
賊	madt
㞬	maf
䝸	mafc
巈	mafo
屸	mag
鄷	magb
艶	magc
㠏	magg
豑	magt
豊	magu
㻃	magy
峫	mahb
㟙	majg
刪	majh
嶱	majn
䞁	majv
贎	majy
冊	mak
嶇	makk
巏	maky
購	mamf
岠	mang
㞽	mann
㤟	manu
䢗	mapd
㠓	mape
嵽	maqh
嶜	maqj
峣	matq
贓	mauh
㟟	mawb
㠛	mawc
䐌	mawe
㟷	mawk
覥	mawq
觍	mawq
敟	mawt
戝	may
㟐	mayn
㕀	mbb
㞨	mbg
邖	mbh
郥	mbh
崡	mbib
貤	mbn
㟹	mbqb
㞧	mbr
屷	mbt
㠕	mbrc
嶐	mbtg
岥	mby
貱	mby
岋	mbyy
峅	mcah
㽕	mcb
嵾	mcce
贂	mcce
㠁	mcce
㟥	mcde
禸	mci
貽	mckg
賐	mcwt
巁	mday
㿮	mdby
贆	mddd
峟	mdef
賄	mdeg
賬	mdey
賑	mdfe
峚	mdff
崕	mdff
䝽	mdff
㟁	mdfh
䞅	mdfk
嵗	mdgh
嵅	mdgk
㼜	mdgy
艷	mdhc
岯	mdhg
豓	mdhl
豔	mdhl
巎	mdht
豒	mdht
豐	mdhu
㞸	mdhu
輋	mdlj
㪜	mdmc
䞂	mdmd
剬	mdmj
峏	mdmj
耑	mdmj
顓	mdmm
䳪	mdmo
歂	mdmw
崸	mdmy
頔	mdmy
㼷	mdmy
峸	mdnn
㟌	mdny
䒋	mdqc
鴦	mdqo
屵	mdr
㟲	mdri
㟶	mdri
㟢	mdsk
嶏	mdsn
㠣	mdth
嶚	mdui
嶛	mdui
嶡	mduw
嶥	mduw
賰	mdwj
䞐	mdwj
嵁	mdwn
峽	mdww
㠌	mdww
嵟	mdwy
髒	meaa
嶾	mean
䯦	meaw
骮	meay
㟊	mebg
骳	meby
䯝	mede
顝	medm
骻	medn
髄	medp
䯋	medy
䣙	meeb
剻	meej
䯇	meet
骽	meev
冑	mef
䯓	meff
骭	mefh
髐	mefq
䯈	mefq
岄	meg
嵈	megc
骬	megf
岨	megg
骾	megr
嶼	megw
㠘	megw
㟬	mehc
髗	mehl
骴	mehx
䯑	meiq
䯠	mejl
䯥	mejo
䯜	mejr
髃	mejy
䯣	mekm
髏	melv
䯞	memk
體	memu
䯐	memw
㲘	men
髎	mene
䯆	menn
䯌	menv
髍	meos
䯔	mepa
䯛	mepb
髕	mepm
䯘	mepq
髉	mepy
髖	mepy
骲	meqn
鶻	meqo
䯉	meqw
屴	mer
髆	mesf
骵	mesg
䯊	mesk
䯙	mesy
䯏	metd
䞈	meto
䯕	metp
䯒	mets
骿	meua
髊	meua
䯟	meue
骹	meur
䯡	meuw
㟎	mevg
崢	mevh
骩	mevn
骫	mevy
䯍	mewc
䯎	mewf
䯤	mewj
骪	mewy
嵠	mexd
䯚	mexe
䯗	mexf
髇	meyk
䯖	meyv
骯	meyw
髈	meyy
賳	mfak
嶻	mfay
賎	mfay
冃	mfd
冄	mfd
嶿	mfdj
亗	mff
崶	mfff
嶀	mffn
嶢	mffq
嶤	mffq
䝰	mffy
屽	mfh
巔	mfhm
嵮	mfhw
曱	mfk
郮	mfkb
彫	mfke
㓮	mfkj
翢	mfkn
鵰	mfko
週	mfkp
贖	mflm
嶹	mfnf
䎃	mfng
㟑	mfpb
岏	mfqn
貦	mfqn
崁	mfqw
㞿	mfru
賭	mftj
財	mftt
峔	mftx
䶲	mftx
崚	mfwt
崋	mgag
㟖	mgaj
賦	mgay
峌	mgcf
䞃	mgct
嶳	mgef
崝	mgeg
䝼	mgeg
䞍	mgeg
㠝	mggm
賕	mgiy
㟈	mgiy
峘	mgjg
畁	mgjj
峺	mgjr
戙	mgka
敱	mgkc
獃	mgkd
峿	mgkg
剴	mgkj
颽	mgkj
顗	mgkm
迵	mgkp
覬	mgkq
敳	mgkt
豈	mgku
凱	mgkw
㖯	mgkx
㢥	mgky
嶆	mgmj
甹	mgnb
䳙	mgno
㼘	mgny
峛	mgqj
峢	mgqj
屼	mgqn
㟼	mgqt
㠂	mgqt
岼	mguf
崨	mgvh
峓	mgxw
帴	mhaa
幙	mhad
㡕	mhad
幪	mhae
㡚	mhaf
㡛	mhak
幊	mham
幉	mhas
幭	mhaw
㡇	mhbn
㠷	mhby
幓	mhce
㡎	mhce
帊	mhcn
帪	mhde
帳	mhde
㡡	mhdf
帞	mhdj
幁	mhdm
㡁	mhdn
㡋	mhdn
帺	mhdw
帗	mhdy
幍	mhee
㡥	mhen
㡪	mhet
甴	mhfd
幬	mhff
帾	mhfj
幩	mhfm
巇	mhga
円	mhgd
巘	mhgd
巚	mhgd
峠	mhgh
㡟	mhgj
幘	mhgm
帓	mhgs
㠸	mhgy
㼙	mhgy
幀	mhhm
㥈	mhhn
帩	mhie
幥	mhir
㠺	mhit
㡌	mhje
幜	mhji
幆	mhjn
㡢	mhjq
幝	mhkf
岾	mhkg
貼	mhkg
幧	mhks
幗	mhlg
㠠	mhll
㡞	mhlv
幈	mhna
幃	mhng
貝	mhny
幮	mhof
㡤	mhof
㠊	mhog
帵	mhpb
幏	mhpe
㡓	mhpl
㡦	mhpm
幰	mhpn
帎	mhpq
幎	mhpu
㡧	mhpu
㡊	mhqe
㡄	mhqj
峴	mhqn
㡅	mhqq
㡈	mhqq
幨	mhqy
㠼	mhrh
㡒	mhrh
㡗	mhrw
帄	mhsh
幖	mhsi
幯	mhtb
帲	mhtf
㡖	mhtf
幒	mhtn
幠	mhto
㡝	mhtp
㠽	mhtu
㠶	mhtw
㡙	mhtx
㒳	mhty
帡	mhua
㡐	mhuj
幱	mhul
帨	mhuq
帹	mhuv
㡘	mhuw
㠴	mhvy
帿	mhwd
㡨	mhwg
䞊	mhwh
㡜	mhwi
㠹	mhwj
㡏	mhwj
帢	mhwk
㡃	mhwk
㡠	mhwu
帉	mhwv
㠲	mhxn
㡉	mhxx
幟	mhyj
䶓	mhyj
㡆	mhyk
巌	midt
埊	miff
崉	mijg
䞆	mimy
贘	mipm
汖	miu
巀	miwa
㞱	mjf
嵵	mjff
䍏	mjgd
崼	mjgh
崵	mjgr
則	mjh
賵	mjhg
赗	mjhg
䞎	mjjg
嵎	mjmy
嵑	mjqn
賜	mjqr
崐	mjxx
崑	mjxx
嶯	mkby
冋	mkd
㞻	mkgn
㞲	mkhh
㠆	mkkf
賗	mkkh
嵓	mkkk
崿	mkkn
贃	mkkn
㟧	mkkn
㠋	mkkn
巖	mkkt
巗	mkkt
㢠	mkpd
岲	mkqn
貺	mkqn
㟕	mkuf
嶉	mkwy
崓	mldg
嶧	mlff
嵔	mlge
㟪	mlge
㟵	mlgh
嶵	mlhd
㠑	mlhd
㠥	mllf
䞏	mlny
嶃	mlrh
嶄	mlrj
㟺	mlvf
嶁	mlvg
嶩	mmae
賟	mmaw
㟨	mmdj
㠦	mmdu
岟	mmdy
峀	mmf
賙	mmfk
赒	mmfk
㟘	mmfk
峝	mmgk
嵦	mmgu
甖	mmgy
屾	mmh
岀	mmj
崱	mmjj
贔	mmmu
赑	mmmu
巊	mmmv
鑍	mmqf
鸎	mmqo
䴍	mmqo
罌	mmtb
贁	mmty
崗	mmum
㟠	mmum
嬰	mmvf
鸚	mmvo
䨉	mmvy
賏	mmy
譻	mmyf
㟭	mnaj
㐕	mnb
崫	mnbm
崌	mndg
䝻	mndg
嶎	mnff
㟃	mngk
䝪	mnhy
㠔	mnku
冎	mnmb
剮	mnmj
咼	mnmk
䫚	mnmm
過	mnmp
旤	mnmq
歄	mnmw
乢	mnn
㠄	mnrf
嶍	mnrg
囘	mnv
嵺	mnwe
賿	mnwe
㞾	mnxn
䝲	mnyu
賍	mofg
賘	mofy
嶗	mooe
巆	mook
嶸	moos
賧	mooy
㠧	mosd
嶪	mouf
嶫	mouf
㠚	mouf
贌	moug
㟾	movh
嵻	movi
嵣	movk
廸	mpd
峵	mpdc
賩	mpfi
㓽	mpfj
䢙	mpi
㟰	mpju
辿	mpk
賱	mplh
㟦	mplj
䝹	mpqb
貯	mpsh
㟉	mptg
㟯	mptk
㞫	mpu
峖	mpvg
㟮	mpwd
嵱	mpwk
賝	mpws
岤	mpwy
岮	mpxn
崏	mqaj
㞴	mqan
岻	mqay
貾	mqay
觃	mqbd
岇	mqbj
峗	mqdb
峞	mqdb
嶦	mqdy
贍	mqdy
嶰	mqeg
崅	mqeh
崟	mqf
崯	mqg
嵥	mqgs
賯	mqjb
嶑	mqke
䝭	mqkg
巉	mqky
翙	mqng
嶌	mqou
嵨	mqoy
嶋	mqoy
鵙	mqoy
嵚	mqqw
嶔	mqqw
岉	mqrt
嶽	mqtd
䝧	mqug
㰞	mqwy
嵧	mqyl
㞮	mqyu
㟅	mrbq
嵏	mrbt
嵕	mrbt
岅	mrcy
販	mrcy
㟸	mrdf
㟓	mrdh
㟛	mrff
岴	mrg
岶	mrg
崲	mrgg
岓	mrh
罓	mri
㟫	mriy
㟴	mrqc
㠢	mrqe
䍑	mrrf
䍞	mrrg
羀	mrrl
崥	mrtf
嶊	mrwy
嶘	msaa
嵿	msdm
㟽	msfi
㠒	msfj
賻	msfy
崬	msjf
崠	msjg
嵖	msjg
贉	msjh
㞹	mskg
㠨	msrf
崊	mssy
㟳	mssy
㟣	mswc
崍	msww
峬	msy
䝵	msy
嵀	msyg
䝯	mtbn
䞌	mtdg
峯	mtdh
嶠	mtdk
㠐	mtdk
㞺	mtdu
岆	mtdy
崻	mtff
㞰	mtfh
峼	mtfk
巑	mtfm
崜	mtfa
貹	mtgg
岝	mthf
岞	mthf
䝫	mthf
嵲	mths
峲	mtjj
峉	mtkf
峈	mtkg
賂	mtkg
賉	mtlg
㠗	mtmd
嶶	mtmt
巋	mtnh
嶭	mtnu
嶓	mtol
貶	mtpy
㠟	mtqi
峩	mtry
㠅	mttt
嵙	mtuf
峂	mtuy
崣	mtvf
嵂	mtvg
嵷	mtwh
嵸	mtwh
敗	mty
內	mtyi
㞥	mtyu
嵳	muaf
賆	muah
胐	mubm
脧	muct
巃	mued
巄	mued
贚	mued
岦	muf
㞳	mufh
䏓	mufq
㟡	mugb
嵄	mugd
㠈	mugg
䞉	mugm
㟱	mugo
嶬	mugy
㠖	mugy
㟄	muh
峷	muj
㠉	mujf
賠	mukg
㟝	mukg
嵜	mukh
﨑	mukh
㟋	mukq
嶒	mulj
贈	mulj
剛	mumj
岡	mumk
嶈	muqf
脁	muqi
胊	muqk
峧	mury
賋	mury
嶟	musf
崷	musg
䞋	musq
嵃	mute
嵼	mutg
巙	mutt
巕	mutv
膧	muuf
嵰	muvw
賺	muvw
賹	muwl
㒺	muwn
肦	muwv
峍	mvgh
贐	mvhl
㟤	mviu
岧	mvkf
岹	mvkg
崰	mvlg
屶	mvr
峮	mvtk
㟒	mvtk
峎	mvu
岃	mvyu
屻	mvyy
嵡	mwcn
䝩	mwet
賒	mwfi
崘	mwga
崙	mwga
峑	mwgf
崄	mwgg
崳	mwgj
峆	mwgk
峇	mwgk
嶖	mwgn
賖	mwgs
嶮	mwgw
㒷	mwgw
峜	mwhf
峳	mwht
岕	mwjj
冏	mwkd
㕯	mwkd
䢛	mwkp
㞦	mwn
䞀	mwnd
嵐	mwtj
㞤	mwu
岎	mwvt
㟗	mwvv
㟇	mwwf
㟆	mwxf
酅	mwyb
岺	mwyc
㔒	mwyj
嵢	mwyk
巂	mwyk
賶	mwyk
㟏	mwyk
㟔	mwyk
嶺	mwym
䫈	mwym
岒	mwyn
嶲	mwyn
嶕	mwyo
嶣	mwyo
䳥	mwyo
䳽	mwyo
㠍	mwys
㠎	mwys
㞩	mwyu
岰	mxet
巓	mxhm
岪	mxjj
嵹	mxkj
㟜	mxqi
㠜	mxth
嵶	mxuu
䫜	mxxm
㟂	mxy
雘	myac
䵊	myaw
䢷	mybh
㠡	myce
訔	myf
䝬	mygg
㠇	myiy
䝶	myiy
峕	myjf
刐	myjh
㠤	myke
巐	myma
嵪	mymk
峐	mynw
賅	mynw
㠙	mype
嵉	myps
鴅	myqo
崺	mytb
㞵	myu
㠃	myud
崹	myuh
嵭	myuy
崀	myvu
㟍	myvy
崒	mywf
崪	mywf
賥	mywf
貥	mywn
㥖	mywn
䝮	myxy
㞶	myy
㞡	naae
悈	naah
㥾	naak
恜	naay
㥇	naay
䎒	naay
䪸	nadm
愜	nadw
愅	nafh
㦐	nafy
羾	nag
恇	nagg
㦊	nagg
戼	nagn
㥱	nahd
慳	nahf
懢	nahl
㤉	naht
敯	najc
慔	najd
昬	najf
刡	najh
愺	najh
蟁	najj
愝	najv
懄	nake
惐	nakg
慬	nakg
慪	nakk
懽	naky
㥸	naln
懜	nalq
懱	nalw
愥	namd
愩	namy
慲	namy
怇	nang
怈	nann
怴	nann
䎀	nann
屟	nans
惵	nans
懞	nape
㦅	naqh
憯	naqj
憽	naqn
鴖	naqo
睯	nath
暋	natj
㟩	natm
敃	naty
㦜	nawc
壂	nawf
臋	naww
㤜	nawy
㤨	nawy
䎉	nawy
恾	nayn
懾	nbbb
㞌	nbd
憜	nbde
㦩	nben
聼	nbfn
邔	nbh
䣁	nbh
㥛	nbkg
㤕	nbmh
鶌	nbmo
忚	nbn
㤴	nbnn
䎎	nbnn
㦕	nbtg
饏	nbtv
怶	nby
翍	nby
忣	nbyy
惙	nccc
慘	ncce
愑	ncee
悀	nceh
㞋	nci
忬	ncnh
憰	ncnk
恈	nctg
㞎	ncv
慅	ncyj
㣾	ncyy
墯	ndaf
翇	ndcy
㤢	ndeg
懮	ndet
悵	ndey
屒	ndfe
㤒	ndfh
㦋	ndfj
恗	ndfn
恠	ndhf
怌	ndhg
慽	ndhi
㤳	ndhk
懳	ndhn
䎚	ndhn
懨	ndjd
㤿	ndjn
㤑	ndkg
愐	ndlf
愞	ndmd
頨	ndmy
㥧	ndmy
䪱	ndmy
㤶	ndny
鶋	ndqo
㥳	ndri
慡	ndrr
㥓	ndsk
㤽	ndtf
憭	ndui
㞠	ndui
㥭	ndwi
愖	ndwn
㠱	ndwu
悏	ndww
翜	ndww
㥍	ndwy
忕	ndy
忲	ndyy
懚	nean
毣	neb
屘	nebd
恊	neee
愶	neee
慆	neeg
㥊	neeg
屗	nefi
愋	negc
怚	negg
懙	negw
㥰	nehc
㞙	neii
㥅	nepc
懓	nept
㥒	nesy
忇	net
愮	netb
㥚	newy
慀	nexd
懴	nfag
憤	nfam
屆	nfbk
㤼	nfce
厾	nfci
㥺	nfcl
忶	nfcy
翄	nfcy
㥘	nfcy
㤬	nffg
㞑	ninv
憢	nffq
㤌	nfg
忓	nfh
㥀	nfhg
屚	nfi
叞	nfic
褽	nfie
犚	nfig
螱	nfij
蝨	nfjj
卂	nfk
憉	nfke
懛	nfkf
恄	nfkg
憘	nfkk
㦭	nfkw
懤	nfnf
㷉	nfof
懗	nfoo
㤸	nfoy
懥	nfph
㦉	nfpu
忨	nfqn
鳵	nfqo
䣝	nftb
愭	nftj
㥩	nftj
鷵	nfto
恅	nftx
懎	nfwk
㥄	nfwt
怽	nfy
忳	ngbn
恎	ngcf
剭	ngcj
悿	ngdn
㞘	ngey
䍿	ngf
忹	ngg
卐	nghg
恆	nghg
㥼	ngho
㞗	ngiy
㤹	ngiy
慱	ngjf
憓	ngjn
丮	ngk
孠	ngkb
愊	ngkl
覗	ngkq
㤦	ngkr
㤱	ngku
䛐	ngky
㤄	ngmh
慒	ngmj
怲	ngmw
㥽	ngmy
㤡	ngqj
慠	ngqt
屍	ngqx
悽	ngvv
恞	ngxw
夨	ngyi
臦	nhah
臩	nhaj
燛	nhao
郿	nhbh
叏	nhcu
収	nhcy
⺪	nhd
屝	nhdd
叚	nhfc
䫗	nhfm
㰺	nhfw
懅	nhge
卍	nhgh
戄	nhhc
懼	nhhy
疍	nhjg
丩	nhk
怗	nhkg
㿿	nhlf
㠯	nhng
憈	nhog
悓	nhqn
鶥	nhqo
疎	nhsk
㦆	nhtf
⺗	nhty
氹	nii
䎓	nijg
劚	nilj
屬	nilj
斸	nilr
憆	nipf
戃	nipo
悩	nirb
㓾	nitj
遲	nitp
懪	njai
㥂	njgf
惿	njgh
翨	njgh
愓	njgr
愰	njiq
㦙	njmn
㥥	njmy
䎈	njnt
愒	njqn
㤤	njry
惈	njsy
惃	njxx
㥗	njyy
悁	nkeg
吢	nkf
郼	nkgb
韕	nkgb
䪗	nkgc
䪝	nkgc
悮	nkgd
韒	nkge
韔	nkge
韛	nkge
韜	nkge
韚	nkgf
韝	nkgf
韟	nkgf
䪙	nkgf
悜	nkgg
韠	nkgg
韡	nkgg
䪒	nkgg
䪘	nkgh
韋	nkgj
韣	nkgj
韐	nkgk
䪓	nkgk
韗	nkgl
韞	nkgl
䪛	nkgl
韥	nkgm
韢	nkgn
䪚	nkgn
䪕	nkgo
違	nkgp
韎	nkgs
韖	nkgs
韘	nkgs
䪔	nkgs
䪐	nkgt
䪖	nkgt
韤	nkgw
䪏	nkgw
䪑	nkgx
韌	nkgy
韍	nkgy
䪜	nkgy
翀	nkhh
憒	nkhm
㥙	nkhn
䎌	nkhy
憚	nkkf
懆	nkks
㦍	nkkt
屌	nkmh
愪	nkmy
悞	nknd
怳	nkqn
孹	nkub
礕	nkud
䴙	nkug
幦	nkuh
躄	nkuh
繴	nkui
㵨	nkui
憵	nkun
糪	nkuo
鷿	nkuo
鸊	nkuo
䢃	nkur
鼊	nkux
怾	nkwy
慖	nlag
乪	nld
屇	nld
㥜	nleg
懌	nlff
怬	nlg
愄	nlge
懁	nlge
㥵	nlge
恛	nlkg
愢	nlny
慩	nlpy
翴	nlpy
慚	nlrh
屢	nlvd
慺	nlvg
慍	nlwl
㦬	nlxy
㦒	nlyg
憹	nmae
㥏	nmaw
愲	nmeg
怞	nmg
愷	nmgu
㕞	nmhc
屃	nmi
屓	nmi
㞯	nmj
惻	nmjh
屭	nmmm
㤯	nmwk
慛	nmwy
惽	nnaj
怋	nnan
選	nnap
㦑	nnbt
巺	nngw
㥠	nnhe
愇	nnkg
乚	nnll
乛	nnll
𠃌	nnll
⺄	nnll
乁	nnll
乀	nnll
忋	nnn
繠	nnni
橤	nnns
惢	nnnu
㦏	nnnw
鵋	nnqo
慴	nnrg
怭	nntt
憀	nnwe
㥡	nnxs
㤈	nny
懭	noaw
憦	nooe
惔	nooy
憐	noqg
懡	nosc
戂	nosd
㦠	nouf
㥪	novg
㦇	noxx
屪	npdi
㦥	npdn
迉	npe
悰	npfi
愃	npgg
慏	npju
惲	nplh
翚	nplj
翬	nplj
悺	npng
懧	npns
㤖	npsh
㤞	npta
愘	nptk
悾	npwa
屄	npwi
愹	npwk
㤾	npws
惛	nqaj
忯	nqan
怟	nqay
㥮	nqbt
恑	nqdb
㦓	nqdo
憺	nqdy
惂	nqeg
惍	nqg
鸤	nqgg
恌	nqiy
惸	nqjb
怐	nqkg
翑	nqkg
悗	nqkq
愌	nqmd
怉	nqnn
䎂	nqnn
䲩	nqoi
翵	nqoy
鳲	nqoy
㥌	nqoy
㞔	nqqi
恀	nqqy
恟	nqrb
愡	nqrn
㤘	nqvg
忺	nqwy
㰝	nqwy
懰	nqyj
㣿	nqyy
㦻	nray
忷	nrbh
惾	nrbt
翪	nrbt
㤆	nrcy
恡	nrdc
悕	nrdh
習	nrf
翫	nrfq
㤧	nrgk
㥴	nrhw
愾	nroy
惞	nrqw
懫	nrrm
㤊	nrry
飁	nrwj
㦡	nrxs
憿	nryt
慓	nsfi
愽	nsfy
䎔	nsfy
恓	nsg
㤓	nsgg
忊	nsh
杘	nsi
憛	nsjh
懶	nskm
㞖	nsmv
憟	nsoy
㦗	nssi
惏	nssy
慄	nssy
悑	nsy
䎍	nsy
屜	ntan
屧	ntas
邲	ntbh
㤭	ntdj
憍	ntdk
㦀	ntdp
㤇	ntdy
㞚	ntfe
㦧	ntfj
悎	ntfk
㦫	ntfm
慥	ntfp
慟	ntge
屛	ntgf
憮	ntgo
㤚	ntgs
怢	ntgy
翐	ntgy
㞒	nthd
覕	nthq
悧	ntjh
慯	ntjr
㔉	ntkj
憁	ntln
屨	ntlv
恦	ntmk
忔	ntnn
憣	ntol
㞏	ntpi
鴓	ntqo
憡	ntsm
屩	nttk
㞜	nttv
㤏	ntuy
㦢	ntvb
㞞	ntwh
㞛	ntxj
攺	nty
恲	nuah
㞐	nud
憪	nueg
㦦	nueq
㥞	nuey
翋	nug
㥃	nug
惓	nugb
怑	nugh
慻	nugh
㦈	nugl
懩	nugv
愔	nujg
慞	nujh
憶	nujn
屖	nuk
㥉	nukg
層	nulj
㦖	nuny
遅	nupk
遟	nupk
恔	nury
㞟	nusd
㥢	nusg
㦨	nusl
愱	nutd
㦃	nutg
飛	nuth
飝	nuth
屫	nutk
翣	nuvf
懻	nuxw
憫	nuyy
憳	nvaf
怓	nvcy
㦎	nvfg
忰	nvfh
翆	nvfj
妀	nvg
㥆	nviy
䎑	nviy
舝	nvpg
惱	nvtr
㞍	nvyi
㣼	nvyy
慃	nwcn
恱	nwcq
㱼	nwcy
鄝	nweb
㞕	nwed
勠	nwee
剹	nwej
顟	nwem
鷚	nweo
䢧	nwep
翏	nwer
雡	nwey
憏	nwfi
㤔	nwfy
惀	nwga
恮	nwgg
懀	nwgj
悇	nwgs
憕	nwgu
憸	nwgw
乆	nwi
夬	nwi
刔	nwjh
忦	nwjh
悅	nwkq
翭	nwnd
鴂	nwqo
恘	nwsy
㤛	nwtf
凥	nwv
翂	nwvt
㤋	nwvt
懺	nwwg
愯	nwyc
㪬	nwyc
䎆	nwyc
愴	nwyk
㤷	nwyk
忴	nwyn
惗	nwyn
懏	nwyn
鸐	nwyo
䢰	nwyp
䬤	nwyv
忛	nwyy
㥝	nxbg
怮	nxet
㥟	nxey
憴	nxg
愼	nxhw
㞓	nxjd
恉	nxjg
慣	nxmy
迡	nxpv
䲿	nxqo
懝	nxth
愵	nxuu
悂	nxxf
蠿	xxgj
惤	nxyx
惇	nybg
悙	nybh
憞	nybt
㥔	nyce
㤝	nycq
乄	nyi
㣺	nyi
憱	nyiy
翞	nyiy
懠	nyjg
㥫	nyjg
懹	nyke
悋	nykg
懐	nyle
懷	nyle
憻	nylg
懍	nylt
翯	nymk
惼	nyna
悷	nynd
怺	nyni
㤺	nynk
㤥	nynw
㦪	nyoc
㤃	nyt
㥬	nyuy
悢	nyvy
忼	nywn
慉	nyxl
怰	nyxy
忟	nyy
烒	oaay
剫	oacj
糤	oaet
煂	oafh
灴	oag
䉺	oag
燁	oagg
熞	oahf
烥	oahh
㷹	oahj
爁	oahl
糮	oahl
爦	oahq
庌	oaht
㡲	oai
㶹	oaiy
灷	oaj
庴	oajd
糢	oajd
㷬	oajd
焟	oajg
爡	oajj
燤	oajy
䊪	oajy
㢙	oake
熯	oakg
熰	oakk
爟	oaky
庿	oald
㢜	oaln
鄺	oamb
煐	oamd
㢍	oamd
䊔	oamd
煹	oamf
懬	oamn
廣	oamw
焫	oamw
熿	oamw
䊣	oamw
熕	oamy
䊟	oamy
粔	oang
煠	oans
㮡	oans
䗪	oaoj
鷓	oaoo
㫂	oaor
䢠	oapk
廗	oaqh
熸	oaqj
糣	oaqj
燪	oaqn
烵	oaqy
糒	oate
糚	oauf
爤	oaul
糷	oaul
爑	oawo
烡	oawu
庻	oaww
糀	oawx
粠	oawy
㸎	obbb
廰	obfn
廳	obgn
邩	obh
炪	obmh
灺	obn
㢌	obsk
廕	obwc
糝	occe
㷁	oceh
熥	ocep
広	oci
炲	ockg
㷘	ocks
㶦	ocnh
燏	ocnk
煣	ocns
㶼	octd
焌	ocwt
糔	ocyj
爄	oday
糲	oday
炦	odcy
類	oddm
烠	odeg
㷃	odeu
粻	odey
煃	odff
䊀	odg
煘	odgk
炐	odhh
緳	odhi
廈	odht
炋	odhy
㷞	odjb
糎	odjf
粨	odjg
㷈	odjn
糆	odlf
煗	odmd
粫	odmj
糥	odmj
煩	odmy
頪	odmy
庬	odny
烣	odoy
㷧	odri
㢊	odsk
爏	odth
煁	odwn
糂	odwn
㥷	odwn
廝	odwr
燍	odwr
粸	odwy
粀	odyy
粏	odyy
燬	oeac
烰	oebg
粰	oebg
熁	oeee
㶸	oeee
焩	oeeg
熖	oeeg
燲	oeem
㷐	oefg
煖	oegc
㡹	oegd
㶲	oeh
廋	oehc
㷔	oehj
粍	oen
廫	oene
燰	oept
熎	oetb
㽔	oetg
燌	ofam
焼	ofaq
廅	ofcl
熆	ofcl
㷯	ofdg
燸	ofdj
烓	offg
庤	offi
燒	offq
粓	ofg
㶰	ofg
籵	ofh
㶥	ofh
廟	ofje
廚	ofkf
熺	ofkk
糦	ofkk
爧	ofkw
煵	ofmf
䊖	ofmf
燽	ofnf
䊭	ofnf
爀	ofoo
焃	ofoy
㶿	ofpb
䊦	ofpu
庨	oftb
粩	oftx
燵	ofup
燯	ofwc
廧	ofwk
庱	ofwt
㸌	ofwy
籿	ofy
庒	ofyi
㢅	ogak
庉	ogbn
庢	ogcf
㶺	ogdk
烼	ogey
㡰	ogfk
㸇	oggm
炡	oghg
䊜	ogjf
烜	ogjg
煏	ogkl
㢄	ogku
㷮	ogmj
廲	ogmx
廌	ogno
煭	vgqo
粖	ogsy
㶬	ogsy
烴	ogva
䨾	ohdd
㢒	oheg
㸍	ohga
㷾	ohge
爠	ohhy
炶	ohkg
㢚	ohle
廬	ohll
爐	ohll
爈	ohln
粯	ohqn
䙺	ohqn
燦	ohqo
爘	ohqv
庛	ohxv
焇	oieg
䊑	oimk
廠	oimt
糛	oipf
爣	oipo
粆	oitt
黺	oiwv
熦	oiwy
熚	ojag
爗	ojag
熶	ojbc
焨	ojeg
鄽	ojfb
㢆	ojfd
粴	ojfg
㡺	ojgd
糧	ojgf
炟	ojgg
㷸	ojgg
煶	ojgh
䊓	ojgh
煬	ojgr
糃	ojgr
灲	ojh
熀	ojiq
焻	ojjg
爞	ojjj
䊡	ojlc
煴	ojlg
庽	ojmy
㷒	ojmy
㡼	ojnt
㷎	ojqn
焬	ojqr
粿	ojsy
㷄	ojsy
焺	ojta
煋	ojtg
燳	ojvo
焜	ojxx
䊐	ojxx
燝	ojyi
焆	okeg
燀	okkf
焒	okkg
煰	okkk
㶽	okmw
熉	okmy
炾	okqn
㡶	okwi
廙	olaw
熼	olaw
糞	olaw
煾	oldn
煟	oleg
畨	olf
燡	olff
爅	olff
糬	olfj
㷵	olfo
畑	olg
糫	olge
糰	olgf
炠	olh
䊫	olhd
庘	olk
庫	olk
廤	olkx
㐣	olnv
燭	olqj
焑	olsy
廔	olvd
熡	olvg
熅	olwl
燶	omae
粬	omag
煓	omdj
炴	omdy
䊘	omeg
粙	omg
烔	omgk
粡	omgk
廁	omjk
熴	omjx
粣	ommg
廮	ommv
煱	omnk
㢐	omnk
㷨	omth
焵	omum
焹	omun
烱	omwk
熣	omwy
㶧	omwy
烿	omye
㐘	onb
煀	onbm
䊊	onen
籸	onfh
廜	onfj
煆	onhc
炄	onhg
煝	onhg
粈	onhg
応	oni
糏	onie
爥	onij
煒	onkg
廦	onku
㢞	onlw
焗	onnk
慶	onnt
㷷	onnw
熤	onug
熮	onwe
燿	onwy
䊮	onwy
粎	onyy
熫	ooao
爌	ooaw
䊯	ooaw
㷥	oobg
糭	oobt
顃	oodm
㲜	ooen
烾	ooff
粧	oofg
敥	oohc
煔	oohk
覢	oohq
㷀	oonf
㥕	oonu
㲭	oooe
飊	oooj
燚	oooo
燊	ooos
爃	ooos
歘	ooow
㷋	oooy
䊏	oooy
罃	oopb
𤇾	oopb
䃕	oopd
勞	oope
膋	oope
褮	oope
塋	oopf
煢	oopf
犖	oopg
醟	oopg
䁝	ooph
滎	oopi
禜	oopi
縈	oopi
螢	oopj
䪯	oopj
營	oopk
㽦	oopl
嵤	oopm
憥	oopn
䎕	oopn
熒	oopo
鶯	oopo
覮	oopq
鎣	oopq
榮	oops
檾	oops
䝁	oopu
嫈	oopv
焭	oopw
瑩	oopy
甇	oopy
謍	oopy
燐	ooqg
㷠	ooqg
鶑	ooqo
䢯	ooqp
欻	ooqw
䊳	oosd
爜	oouc
㸁	oouf
燫	oouw
煻	oovk
焿	oovw
爊	ooxo
廘	ooxx
熝	ooxx
麊	ooxx
䊌	ooxx
炏	ooy
顲	ooym
爎	opdi
㶶	opey
糘	opge
熐	opju
熍	opkk
煇	oplh
廀	opoc
焥	opqb
㶩	opqn
䊉	opsy
烢	opta
焢	opwa
㷝	opwd
焪	opwx
炨	opxn
䣌	oqab
焝	oqaj
䉻	oqan
㡳	oqav
灮	oqb
煼	oqbt
鄰	oqgb
粦	oqgj
㔂	oqgj
亃	oqgn
翷	oqgn
䚏	oqgq
斴	oqgr
甐	oqgy
焔	oqhj
庣	oqii
烑	oqiy
㶷	oqjg
䊅	oqkg
煥	oqmd
㢝	oqot
廯	oqou
熓	oqoy
粷	oqoy
䲴	oqoy
㢁	oqqi
廞	oqqw
㶴	oqqy
㷓	oqrn
粅	oqrt
㡻	oqtb
㶯	oqtb
䶴	oqwa
㶤	oqy
㡱	oqyi
廇	oqyl
糉	orbt
炍	orcy
粄	orcy
庪	orfc
䊗	orgg
炘	orh
䉼	orh
庍	ork
熂	oroy
廆	orqc
焮	orqw
䊛	orsc
焷	ortf
粺	ortf
螷	ortj
蠯	ortj
廏	orxc
廐	orxq
爍	orxs
燩	oryt
㷑	osff
煙	osfg
熛	osfi
煿	osfy
糐	osfy
庮	osgd
㡷	osgd
㶱	osgg
廂	oshd
烞	oshy
庯	osi
燂	osjh
䊤	osjh
庁	osk
炣	oskg
㸊	oskm
煉	oslg
䊂	osmn
㢀	osmv
黀	ossc
䯢	osse
塺	ossf
犘	ossg
劘	ossj
黁	ossj
䵉	ossj
麿	ossk
黂	ossm
㦄	ossn
爢	osso
㸏	osso
䳸	osso
穈	osst
䵇	osst
麼	ossx
䜆	ossy
爩	oste
庲	osww
炑	osy
烳	osy
䊇	osy
炢	osyy
灹	otan
籷	otan
㡯	otav
炧	otbn
粚	otbn
庅	otci
燆	otdk
㢗	otdk
熢	otdp
㸆	otfd
㢎	otfe
粁	otfh
焅	otfk
烶	otfp
烍	otfq
䊁	otfq
爋	otge
㷲	otge
煄	otgf
廭	otgm
廡	otgo
燻	otgo
㷻	otgo
烆	otgs
㡸	othf
烻	othp
烅	otlg
熜	otln
炿	otmy
㢂	otnd
㷆	otnf
籺	otnn
㷟	otnp
䊚	otnp
㢖	otol
䊩	otol
䊝	oton
煍	otoy
熪	otqq
㢉	otta
䉿	otuf
庝	otui
炵	otuy
烐	otuy
㸅	otvb
㢔	otwh
䊴	otww
烸	otxy
䊈	otxy
炇	oty
秌	oty
庰	ouak
㡿	oubt
㡴	oud
烪	oudy
爖	oued
龐	oued
燗	oueg
糋	ouej
㷙	ouej
煫	ouey
鄴	oufb
叢	oufc
䊋	oufg
炓	oufh
丵	oufj
糳	oufo
鸈	oufo
鑿	oufq
業	oufu
㱉	oufw
䊎	ougb
㲫	ouge
對	ougf
㷣	ougg
䉽	ough
懟	ougn
䴆	ougo
菐	ougu
燨	ougy
爔	ougy
燑	oujf
㢓	oujk
燱	oujn
糡	oujq
廍	oukb
熷	oulj
燜	ouny
爓	ouqe
烄	oury
燇	ousf
煪	ousg
爛	ousl
㷽	ouuk
劆	ouvj
㢘	ouvo
熑	ouvw
熌	ouwy
焍	ouxt
燘	ouyy
燖	ovaf
㶢	ovb
鄘	oveb
㣑	ovee
鷛	oveo
粋	ovfh
熽	ovfj
䊥	ovfj
籹	ovg
㡽	ovgk
煡	ovgp
䊕	ovgp
鄌	ovhb
㲥	ovhe
燼	ovhl
鶶	ovho
㼺	ovhy
㡾	ovi
㱂	oviw
粶	oviy
炤	ovkg
廱	ovky
爉	ovln
㷌	ovph
灱	ovt
廄	ovwc
鹒	ovwg
賡	ovwm
鶊	ovwo
籾	ovyy
焧	owcn
庺	owcs
炂	owcy
炈	owcy
焤	owfo
廃	owfq
爚	owga
㷍	owga
烇	owgg
䊃	owgh
廥	owgj
燴	owgj
糩	owgj
㢏	owgj
烚	owgk
粭	owgk
熻	owgn
庩	owgs
燈	owgu
㢛	owgw
㷿	owgw
庂	owi
炌	owjh
庎	owjk
籶	own
㢋	owqq
烌	owsy
煈	owtj
㥹	owvn
䊱	owwg
噟	owwk
焀	owwk
應	owwn
鷹	owwo
譍	owwy
䧹	owwy
炛	owxb
廢	owxc
㷪	owyb
炩	owyc
㡵	owyc
㢈	owyd
㢑	owyf
焳	owyg
䊒	owyg
熗	owyk
庈	owyn
焾	owyn
燋	owyo
庼	oxdm
廎	oxdm
㶭	oxet
粌	oxhh
纇	oxim
颣	oxim
炥	oxjh
䊧	oxjm
彂	oxtd
㢕	oxty
糑	oxuu
鄜	oxxb
麛	oxxb
麚	oxxc
䴫	oxxc
麌	oxxd
䴠	oxxd
麎	oxxe
塵	oxxf
䴣	oxxf
麆	oxxg
麠	oxxg
䴤	oxxg
麖	oxxi
䴨	oxxi
䴩	oxxi
䴪	oxxi
麘	oxxj
麞	oxxj
麡	oxxj
麍	oxxk
麏	oxxk
麐	oxxk
麔	oxxk
麙	oxxk
麢	oxxk
䴥	oxxk
粃	oxxn
麅	oxxn
麃	oxxo
麑	oxxq
煯	oxxr
麜	oxxs
䴢	oxxs
麕	oxxt
麣	oxxt
䴧	oxxv
麀	oxxx
麤	oxxx
㼾	oxxy
䴟	oxxy
䴦	oxxy
焞	oybg
燉	oybt
焴	oyce
㢇	oyd
庡	oyei
䊰	oyfj
炞	oyhy
㸄	oyjg
爙	oyke
燷	oyli
廩	oylt
燣	oylt
㸀	oymf
熇	oymk
燺	oyms
糄	oyna
熩	oync
粐	oynt
烗	oynw
㷜	oyod
㷚	oyps
煷	oypw
㷰	oyrc
䊞	oyud
熾	oyuj
㢃	oyvi
烺	oyvy
焠	oywf
粇	oywn
焲	oywy
炆	oyy
宧	pahh
寛	pahq
寬	pahy
㝜	pajf
冪	pajh
㝤	pamf
寋	pawb
䞿	pawh
䗙	pawj
賽	pawm
㥶	pawn
騫	pawo
鶱	pawo
弿	pawx
冣	pbcu
㝡	pbcu
㝋	pbj
㝮	pbmc
㝫	pbtg
㝊	pcu
宻	pcum
翝	pdcn
㝒	pdf
㪡	pdhc
㲅	pdhc
㝣	pdhd
㝬	pdhg
鶷	pdho
寕	pdls
宬	pdnb
宊	pdu
実	pdwu
宒	peb
肎	pef
冝	pegf
冩	peqo
寫	peqo
寀	pesu
寪	peto
冡	pfeu
寘	pfhw
崈	pfim
賨	pfim
鶎	pfio
宑	pfjj
㝨	pfke
䢘	pfpi
冦	pfqc
鵍	pfqo
宼	pfqv
㓂	pfqv
宯	pftb
㝪	pfuy
寈	pgef
㝉	pgf
㝞	pgfg
䢓	pgfp
㝙	pggw
賓	pghm
顁	pghm
顮	pghm
䎙	pghn
㝟	pghq
䚔	pghq
䨈	pghy
寭	pgjn
翧	pgjn
䳦	pgjo
冨	pgkl
憲	pdhn
戭	pgma
㪦	pgmt
㝍	pgng
寳	pgqm
寚	pgtb
寶	pgtm
䴐	pgto
寁	pgvh
寊	phmu
宐	phng
鼏	phnn
㓀	phu
㲾	piu
寖	pivc
寔	pjgh
䥌	pjjq
䴁	pjmo
鄍	pjub
䒌	pjuc
䫤	pjum
覭	pjuq
㝠	pjuu
鼆	pjux
宺	pkgk
宲	pksu
宮	pktk
鄆	plbh
皸	plby
顐	pldm
軍	plj
運	plpk
鶤	plqo
寠	plvf
寷	pmdu
冚	pmj
㝕	pncu
㝭	pnjg
㲰	pnle
寍	pnlf
寜	pnlh
鸋	pnlo
寧	pnls
賔	pnmu
悹	pnnu
寗	pntf
䁇	pnth
䀄	pntl
叜	pocu
冞	pou
宩	pou
㝩	povi
㝎	ppu
鹓	pqbg
邥	pqbh
䗕	pqbj
惌	pqbn
鵷	pqbo
䵫	pqbo
䪴	pqdm
瓭	pqgy
沊	pqii
宨	pqiu
寃	pqky
寏	pqmd
鴆	pqqo
㝖	pqqu
冘	pqv
㱽	pqwc
䧵	pqwy
㝌	pqyu
寙	prcy
冟	prxb
䫅	psdm
㿾	pslf
冧	pssu
㝝	pssu
㝯	ptdk
宎	ptdu
㝚	pthp
㝰	pthy
額	ptkm
愙	ptkn
㝢	ptky
⺳	ptnb
㔤	ptoe
審	ptol
覾	ptoq
宷	ptou
裓	puaa
䙁	puaa
襼	puac
䘬	puad
䙩	puae
褠	puaf
㝲	puah
襺	puaj
䙔	puak
襤	pual
襽	pual
袣	puan
㝱	puaq
䙦	puaq
褋	puas
褗	puav
襪	puaw
襔	puay
䘝	puay
䙮	puay
襵	pubb
䘶	pubb
袦	pubm
衪	pubn
衱	puby
襂	puce
䘞	pucg
褬	pucs
褦	pucx
袏	puda
袸	pudb
褉	pudd
䙇	pudd
裖	pude
䙃	pude
袥	pudg
䙯	pudh
䙘	pudi
袹	pudj
袻	pudj
襫	pudj
裿	pudk
袴	pudn
裺	pudn
䘠	pudr
裌	pudw
褀	pudw
䙠	pudw
袚	pudy
褑	puec
寵	pued
䙎	pued
䙀	puee
袓	pueg
䘽	pueq
襷	puer
衼	pufc
袪	pufc
䙥	pufc
褤	pufe
袿	puff
衦	pufh
袆	pufh
袺	pufk
襩	pufm
襭	pufm
襓	pufq
裬	puft
襶	pufw
褹	pufy
䙣	pugd
衧	pugf
䘭	pugf
䙊	pugh
䙐	pugh
褿	pugj
褔	pugl
襀	pugm
襧	pugr
裋	pugu
褄	pugv
寎	pugw
襹	pugx
衭	pugy
裲	pugy
裶	puhd
褃	puhe
裃	puhh
袩	puhk
裭	puhw
䘣	puhx
䘯	puie
褝	puif
襠	puil
襒	puit
䘷	puiy
襊	pujc
䙨	puje
裡	pujf
衵	pujg
裫	pujg
襅	pujg
褆	pujh
襮	puji
裮	pujj
褞	pujl
褟	pujn
裩	pujx
裐	puke
襌	pukf
衶	pukh
䙡	pukm
䙌	pukm
襙	puks
䙓	pulc
裀	puld
襗	pulf
䙟	pulg
䘥	pulh
襡	pulj
褳	pulp
裍	puls
褸	pulv
襬	pulx
䘧	pumd
襛	pume
䙖	pume
衻	pumf
袡	pumf
䘜	pumh
褍	pumj
裯	pumk
䙤	pump
䙬	pumv
袇	pumy
褘	pung
䙙	pung
䙍	punh
䙱	punj
䘿	punm
袐	punt
襈	punw
䘦	punx
袯	puny
襨	puof
襆	puog
褯	puoh
褲	puol
裧	puoo
㝥	puou
䘼	pupb
䙋	pupg
䘺	puph
䙭	puph
褣	pupk
裈	pupl
褌	pupl
䘾	pupn
衴	pupq
䘢	pups
袕	pupw
袉	pupx
衹	puqa
裪	puqb
襐	puqe
䘳	puqg
䘩	puqj
袧	puqk
袳	puqq
袀	puqu
袛	puqy
襜	puqy
袙	purg
䙉	purh
㝔	puru
䘴	pusc
䙏	pusf
褾	pusi
袔	pusk
襋	pusm
襰	pusm
褼	pusn
寴	pusq
䙅	pusv
補	pusy
䘤	pusy
袘	putb
襖	putd
䙄	pute
袾	putf
褈	putf
袟	putg
袶	putg
褷	puth
䙕	puth
袮	puti
襣	putj
裇	putl
襎	putl
襸	putm
䙧	puto
䘰	putp
䙜	putp
寱	puts
裄	puts
裑	putt
複	putt
宍	puu
褨	puua
裷	puub
襱	puud
襉	puue
䙛	puue
襇	puuj
䙢	puuj
襕	puul
襴	puul
襚	puup
裞	puuq
襯	puuq
䘨	puur
䙫	puuw
寢	puvc
䘲	puvc
襑	puvf
䘵	puvi
袑	puvk
袽	puvk
衳	puwc
袊	puwc
襏	puwc
䙆	puwd
䙈	puwd
袗	puwe
袝	puwf
袵	puwf
襥	puwg
襳	puwg
衸	puwj
褕	puwj
襘	puwj
䘛	puwn
䙂	puwn
襍	puws
䙞	puwu
衯	puwv
襝	puww
袎	puxe
褖	puxe
䘟	puxh
褵	puyc
䙗	puyd
䘻	puye
䙑	puye
寣	puyf
䘹	puyf
襢	puyg
褅	puyh
裗	puyk
䙒	puyl
䘪	puyq
袨	puyx
䘸	puyy
䙰	puyy
鞌	pvaf
䢿	pvbh
頞	pvdm
䀂	pvlf
鴳	pvqo
宭	pvtk
䅁	pvtu
㝧	pvwf
䇀	pwab
㲁	pwac
窢	pwag
䆠	pwah
䆰	pwak
䆾	pwal
鵼	pwao
宂	pwb
窷	pwbb
窋	pwbm
窡	pwcc
䆷	pwck
窓	pwcn
䆓	pwcq
梥	pwcs
㝐	pwcu
䆯	pwcv
䆖	pwdc
窫	pwdd
䆜	pwde
䆣	pwde
䢆	pwdf
䢇	pwdf
竂	pwdi
窚	pwdn
鶟	pwdo
窰	pweb
竁	pwee
竄	pwen
窙	pwfb
窐	pwff
穽	pwfj
竇	pwfm
竃	pwfn
窛	pwfv
窴	pwfw
窾	pwfw
竈	pwfx
䆥	pwge
穻	pwgf
䆙	pwgh
㝓	pwgk
䆳	pwgp
窺	pwgq
竀	pwgq
窉	pwgw
㝛	pwgw
䆩	pwhd
䆽	pwhe
窅	pwhf
窧	pwhj
䆮	pwic
窏	pwif
窪	pwif
䆱	pwio
䆨	pwjd
㝏	pwjj
窤	pwjx
䆞	pwjx
䆛	pwka
䆔	pwkh
䆗	pwkh
䆬	pwkm
䆭	pwlf
䆘	pwlj
窶	pwlv
窩	pwmk
䆚	pwmk
䆼	pwmp
穵	pwnb
䆻	pwnt
䆕	pwnw
窲	pwof
䆲	pwoi
䆦	pwoo
窌	pwqb
窞	pwqe
窎	pwqg
窇	pwqn
䆫	pwqn
䆴	pwqn
窵	pwqo
鴧	pwqo
鴪	pwqo
䇁	pwqu
䆢	pwrw
竅	pwrt
窊	pwry
䆑	pwsj
穼	pwsu
罙	pwsu
竊	pwtc
穾	pwtd
宱	pwtf
窂	pwtg
竆	pwtk
䆝	pwtl
䆺	pwtl
窸	pwtn
窻	pwtn
䆤	pwtt
䆧	pwtv
窮	pwtx
㓁	pwu
竉	pwud
䆹	pwuf
䆵	pwuj
窹	pwuk
窯	pwuo
窔	pwur
䆿	pwus
寑	pwvc
窼	pwvs
䆒	pwvy
彮	pwwe
䆟	pwwk
䆶	pwwo
窱	pwws
㮤	pwws
䆸	pwwu
㼸	pwwy
窽	pwxw
㝦	pwyb
隺	pwyd
寉	pwyf
窣	pwyf
寯	pwyn
鶴	pwyo
䆡	pwyv
宆	pxb
宖	pxcu
㼠	pxgy
䙾	pxhq
實	pxmu
迱	pxpv
寲	pxth
祴	pyaa
䄏	pyad
䄍	pyaj
䄁	pyan
䄀	pyay
祂	pybn
礽	pybt
䄌	pycc
祃	pycg
禡	pyco
祳	pyde
䄝	pyde
禥	pydf
祏	pydg
祐	pydk
䄎	pydk
䄋	pydn
禲	pydy
禐	pyec
㝘	pyf
䃽	pyfc
禱	pyff
祎	pyfh
禃	pyfh
禇	pyfj
祮	pyfk
䀅	pyfl
䄣	pyfm
䄊	pyfn
禖	pyfs
祾	pyft
禛	pyfw
䄥	pyfw
祙	pyfy
宔	pygf
祬	pygf
䄚	pygj
禰	pygr
䄈	pygu
䃿	pygy
禎	pyhm
視	pyhq
䃼	pyhy
䄕	pyil
䄗	pyjg
禔	pyjh
䗝	pyjj
禵	pyjm
禢	pyjn
禓	pyjr
祼	pyjs
禑	pyjy
祦	pykd
禪	pykf
䄇	pykg
祌	pykh
祻	pyld
䄄	pyld
禗	pyln
禤	pyln
祵	pyls
禝	pylt
䄛	pylv
禩	pylw
䄃	pymd
禯	pyme
䄂	pymg
禂	pymk
禍	pymk
禮	pymu
祤	pyng
禕	pyng
祕	pynt
禟	pyok
禷	pyom
禈	pypl
䄙	pypu
祇	pyqa
祪	pyqb
祹	pyqb
䄑	pyqj
礿	pyqy
䄡	pyqy
㝑	pyr
禆	pyrf
䄓	pyrg
禠	pyrw
禋	pysf
禣	pysf
禫	pysj
䄤	pysm
㓃	pyta
祅	pytd
䄆	pytd
祣	pyte
祍	pytf
祩	pytf
祑	pytg
祰	pytk
禶	pytm
䄉	pyty
䄔	pyty
禙	pyue
禉	pyug
禭	pyup
祱	pyuq
祶	pyut
禌	pyux
祲	pyvc
祒	pyvk
㝗	pyvu
禴	pywa
祋	pywc
祔	pywf
䄞	pywi
祄	pywj
禬	pywj
䄖	pywj
祫	pywk
䄒	pywn
禒	pyxe
祿	pyxi
禨	pyxw
䃾	pyxx
䄜	pyyc
祽	pyyf
䄠	pyyg
禘	pyyh
䄢	pyyj
禞	pyyk
祊	pyyt
䄘	pyyy
鑶	qaah
鐷	qaas
鉽	qaay
錢	qaay
䥈	qada
鍩	qadk
䥠	qadk
頯	qadm
鏾	qaet
氒	qafj
鐯	qafj
䦃	qafj
鑉	qafl
釭	qag
鏵	qagg
鋣	qahb
鏗	qahf
鑑	qahl
鑦	qahm
鑬	qahq
釾	qaht
䥺	qaht
鑮	qaif
銾	qaiy
鏌	qajd
錯	qajg
䫒	qajm
䤷	qajv
鉕	qakg
鏂	qakk
鑎	qakm
䥲	qakw
鑵	qaky
錨	qalg
鑖	qalw
鍈	qamd
锳	qamd
帋	qamh
鉔	qamh
鐄	qamw
鏋	qamy
鉅	qang
鉞	qann
鉪	qann
鍱	qans
鋱	qany
鐕	qaqj
䲭	qaqo
銰	qary
䥬	qasf
鑝	qatp
钄	qaul
鍣	qavk
鑊	qawc
匒	qawk
鎝	qawk
錵	qawx
鉷	qawy
鈛	qay
㪆	qayc
㲳	qayg
鋩	qayn
铓	qayn
鴟	qayo
䢑	qayp
錺	qayt
釴	qayy
鑷	qbbb
鎁	qbbh
駌	qbco
鋷	qbcy
釨	qbg
鉺	qbg
㼝	qbgy
卬	qbh
夘	qbh
邜	qbh
釕	qbh
䥀	qbhj
䤴	qbib
鐊	qbjr
䖤	qbju
盌	qblf
㽜	qblf
錳	qblg
鈯	qbmh
㠾	qbmh
夗	qbn
釶	qbn
銸	qbnn
鴛	qbqo
錒	qbsk
釢	qbt
皺	qbtb
鄒	qbtb
鶵	qbto
芻	qbtt
㱀	qbtw
雛	qbty
䥙	qbue
妴	qbvf
鈹	qby
鈒	qbyy
钑	qbyy
錣	qccc
鏒	qcce
鎟	qccs
銿	qceh
鈶	qckg
䥁	qclf
鈀	qcn
鐍	qcnk
鍒	qcns
鎷	qcoy
鈗	qcqn
鉾	qctg
鋑	qcwt
釵	qcyy
䤻	qdae
䥄	qdaj
䥦	qdap
䣀	qdbb
㩻	qdbc
頠	qdbm
鈪	qdbn
鈜	qdcy
鈸	qdcy
銪	qdeg
鍸	qdeg
䥳	qdet
鋹	qdey
錛	qdfa
鋠	qdfe
䥎	qdfe
鍷	qdff
鎒	qdff
錼	qdfi
銙	qdfn
鈷	qdg
鉐	qdg
銊	qdgg
鍼	qdgk
銌	qdhb
䥹	qdhb
鍥	qdhd
銔	qdhf
鉟	qdhg
鏚	qdhi
䥛	qdhi
䤿	qdhr
鏏	qdhv
鈈	qdhy
銆	qdjg
匎	qdjn
䤶	qdjn
鈽	qdmh
顉	qdmy
鋮	qdnn
䤞	qdny
䳿	qdoo
鋴	qdqn
厃	qdr
䤺	qdrh
鏯	qdrr
錡	qdsk
锜	qdsk
䦁	qdtb
矦	qdtd
鋳	qdtf
䥶	qdth
鐐	qdui
鐝	qduw
䥓	qdwf
鍖	qdwn
鐁	qdwr
鋏	qdww
甔	qdwy
錤	qdwy
釱	qdy
鈦	qdyy
觨	qeai
觾	qeao
䚢	qeas
觵	qeaw
䚭	qeay
鋢	qebg
觙	qeby
觭	qedk
錋	qeeg
䤾	qeeg
觬	qeeq
觔	qeet
臽	qef
觟	qeff
觰	qefj
鋝	qefy
鈅	qeg
鍰	qegc
鋤	qege
鉏	qegg
䚙	qegg
㐥	qegn
觩	qegy
鎪	qehc
觘	qeit
䚟	qejf
觛	qejg
㓩	qejh
䚣	qejh
䚠	qejx
䚤	qejy
觶	qekf
鉫	qekg
䚪	qele
觸	qelj
䚡	qeln
觿	qemk
觽	qemn
䚧	qene
觓	qenh
䚬	qeog
燄	qeoo
鑀	qept
觗	qeqa
觤	qeqb
鹐	qeqg
鵤	qeqo
鵮	qeqo
觼	qeqt
欿	qeqw
觝	qeqy
䚜	qerf
觻	qers
䚦	qerw
䚞	qesw
釛	qet
釤	qet
鎐	qetb
觡	qetk
䚛	qetk
䚩	qetk
㷺	qeto
䚚	qetq
觴	qetr
觲	qeug
觧	qeuh
觪	qeuh
㙰	qevf
鋖	qevg
觮	qevi
䚗	qewc
䚨	qewc
觹	qewn
䚥	qexu
䚝	qeyf
鐵	qfag
鐼	qfam
鐡	qfau
銭	qfay
䥫	qfay
鎑	qfcl
㔩	qfcl
鈘	qfcy
鉣	qfcy
勻	qfd
鑐	qfdj
銈	qffg
鐃	qffq
䥗	qffw
釷	qfg
鉗	qfg
針	qfh
釬	qfh
㚈	qfh
鎮	qfhw
銢	qfiy
鎱	qfke
銡	qfkg
鐳	qflg
鑟	qflm
鑄	qfnf
釫	qfnn
鋕	qfny
䤲	qfoy
鋍	qfpb
鎍	qfpi
鈨	qfqn
䥤	qfqn
䥻	qfqn
銇	qfsy
﨧	qftb
鍺	qftj
銬	qftn
釮	qftt
銠	qftx
﨨	qfuf
鐽	qfup
錴	qfwf
錂	qfwt
鳠	qgac
䤯	qgae
鈃	qgah
钘	qgah
鉶	qgaj
铏	qgaj
錻	qgay
鈍	qgbn
鲏	qgby
鲬	qgce
鲹	qgce
銍	qgcf
铚	qgcf
鲃	qgcn
銒	qgdf
䲠	qgdj
鳡	qgdn
鲯	qgdw
錆	qgeg
錶	qgey
㘶	qgff
錏	qgfg
釪	qgfh
鐚	qgfn
鲓	qgfn
錱	qggf
鐟	qggj
鲾	qggl
鑚	qggm
鲀	qggn
鉦	qghg
鈣	qghn
鲿	qgic
䲤	qgig
銶	qgiy
䦄	qgje
鏄	qgjf
鳀	qgjh
鐂	qgjl
鳁	qgjl
鏸	qgjn
鋙	qgkg
铻	qgkg
鎘	qgkh
鑩	qgkk
鍢	qgkl
鋀	qgku
鳂	qgle
鲉	qgmg
鏪	qgmj
鲗	qgmj
鲖	qgmk
鈵	qgmw
䥊	qgmy
鳚	qgnf
鱾	qgnn
鳛	qgnr
鋄	qgoc
铔	qgog
錽	qgot
䲟	qgqb
鲌	qgrg
鳈	qgri
鲘	qgrk
鲄	qgsk
鲊	qgtf
鳤	qgtn
匉	qguf
鳉	qguf
䲡	qgug
䲞	qgug
鳒	qguw
鋞	qgva
鲪	qgvk
鱽	qgvt
䲝	qgwb
鲙	qgwc
鑈	qgwr
銕	qgxw
鈇	qgy
鳣	qgyg
鈺	qgyy
鳑	qgyy
鑡	qhbh
鈙	qhcy
䀏	qhd
䤵	qhdd
鐬	qhdh
錹	qheg
鉬	qhg
䤠	qhg
钀	qhgd
鐻	qhge
钁	qhhc
䦆	qhhc
䀤	qhhf
䤮	qhht
鉲	qhhy
鑺	qhhy
亇	qhj
鋽	qhjh
鉆	qhkg
夞	qhkx
鐪	qhle
鑪	qhll
鑢	qhln
鏀	qhlo
㔪	qhlo
鍞	qhmy
鐤	qhnn
䥧	qhph
迯	qhpi
鋧	qhqn
鎼	qhrh
鏬	qhtf
錿	qhwn
釙	qhy
頫	qidm
銷	qieg
鍅	qifc
銧	qigq
覙	qihq
覜	qihq
䤬	qiit
錔	qijg
鐋	qijr
鋿	qimk
鎖	qimy
鏜	qipf
鏛	qiph
鐺	qipl
鑜	qipm
钂	qipo
鎲	qipq
镋	qipq
鐣	qipr
鏿	qips
鴵	qiqo
鎃	qire
鈔	qitt
䥕	qity
淾	qiu
釥	qiy
鏎	qjag
鑤	qjai
㝁	qjbf
鋰	qjfg
銲	qjfh
䥵	qjfq
鈤	qjg
鍀	qjgf
鉭	qjgg
鍉	qjgh
鍚	qjgr
釗	qjh
鉮	qjhh
鎤	qjiq
錩	qjjg
锠	qjjg
亀	qjjn
鏝	qjlc
鎾	qjlg
鍝	qjmy
鎉	qjng
迿	qjpd
銞	qjqf
鍻	qjqn
錫	qjqr
㰬	qjqw
錁	qjsy
鍟	qjtg
䥪	qjxo
錕	qjxx
鉵	qjy
鐛	qjyi
鍓	qkbg
邭	qkbh
䪷	qkdm
勨	qkee
鋗	qkeg
㲒	qken
䴂	qkeo
䤢	qket
釦	qkg
鋘	qkgd
鋥	qkgg
釧	qkh
鈡	qkhh
鏴	qkhk
鐀	qkhm
鑓	qkhp
鋜	qkhy
鋁	qkkg
鋛	qkkh
鍔	qkkn
鐰	qkks
銱	qkmh
㗮	qkow
鴝	qkqo
鵵	qkqo
欨	qkqw
斪	qkrh
鉂	qkry
敂	qkty
鉙	qkwy
雊	qkwy
酁	qkxb
㚟	qkxd
䵶	qkxg
劖	qkxj
㲋	qkxx
毚	qkxy
䥯	qlcx
錮	qldg
銦	qldy
鐸	qlff
鈿	qlg
鍡	qlge
鐶	qlge
镮	qlge
鎠	qlgh
鉀	qlh
䤽	qliy
䤧	qlkg
鑸	qllf
鑘	qlll
錷	qlnn
鍶	qlny
鏈	qlpy
鐲	qlqj
鏩	qlrh
鏤	qlvg
鎅	qlwj
鏍	qlxi
鑼	qlxy
錪	qmaw
錌	qmdf
鍴	qmdj
鉠	qmdy
鏰	qmee
镚	qmee
䤡	qmfg
錭	qmfk
鈾	qmg
銅	qmgk
鎧	qmgu
鍘	qmjh
島	qmk
銏	qmmg
銟	qmmh
鍋	qmnk
鐹	qmnp
䤱	qmrh
鎽	qmth
負	qmu
鋼	qmum
奐	qmwd
鑴	qmwk
䤫	qmwn
䥴	qmwn
烉	qmwo
夐	qmwt
敻	qmwt
䏑	qmww
鈉	qmwy
鏙	qmwy
鋇	qmy
鍲	qnaj
鈱	qnan
饳	qnbm
馂	qnct
鋸	qndg
馌	qnfl
鈻	qng
䦀	qng
鉰	qngk
饾	qngu
鍜	qnhc
鈕	qnhg
鎇	qnhg
䤛	qnhh
钃	qnij
䭪	qnjf
馃	qnjs
鍏	qnkg
鐴	qnku
馉	qnme
釓	qnn
釔	qnn
釲	qnn
鋦	qnnk
鐉	qnnw
炰	qnou
钖	qnrt
馎	qnsf
饤	qnsh
饦	qnta
饹	qntk
鉍	qntt
䥽	qnty
鏐	qnwe
镠	qnwe
饸	qnwk
鈌	qnwy
鑃	qnwy
鈮	qnxn
鈊	qny
饻	qnye
鉯	qnyw
鈬	qnyy
䱠	qoaa
鍍	qoac
鱯	qoac
鸌	qoac
鰳	qoae
䴌	qoae
鰹	qoaf
魟	qoag
䱛	qoag
䱌	qoah
䲛	qoah
䱜	qoaj
鰙	qoak
鰸	qoak
䳼	qoak
鮔	qoan
鏣	qoao
鰈	qoas
鰋	qoav
鑛	qoaw
鱑	qoaw
鱴	qoaw
䱋	qoaw
鱹	qoay
䰹	qoay
䱆	qobb
鯫	qobc
䲊	qobe
䰵	qobg
鄔	qobh
鄥	qobh
鯭	qobl
鮿	qobn
䳖	qobn
鑁	qobt
魥	qoby
鮍	qoby
鯒	qoce
鯵	qoce
鰺	qoce
魣	qoch
鰠	qocj
鮐	qock
鱊	qock
䰾	qocn
鰢	qoco
鷌	qoco
鰇	qocs
鮻	qoct
鵔	qoct
鉱	qocy
䱮	qodd
鮪	qode
鰖	qode
鰗	qode
䱳	qodf
魾	qodg
鮕	qodg
鮖	qodg
䰷	qodh
爒	qodi
䱞	qodi
鮞	qodj
鰆	qodj
鰔	qodk
鮬	qodn
鯎	qodn
鱤	qodn
䲉	qodr
鰄	qodv
鯕	qodw
鱖	qodw
鶀	qodw
魷	qody
鮁	qody
鱱	qody
䲦	qody
䳁	qody
鰩	qoeb
䱐	qoeb
鰀	qoec
䱸	qoec
䳶	qoed
䱉	qoeg
魹	qoen
鯢	qoeq
鶃	qoeq
鱫	qoet
鳨	qoet
鮾	qoev
鱮	qoew
魼	qofc
鮭	qoff
鯥	qoff
䲖	qoff
魽	qofg
鯐	qofh
䱈	qofi
鯺	qofj
鰭	qofj
鱬	qofj
鮚	qofk
鱚	qofk
鰪	qofl
鱩	qofl
鱝	qofm
鮳	qofn
魭	qofq
鱙	qofq
鯪	qoft
鱈	qofv
䲌	qofw
鮱	qofx
鮇	qofy
鯖	qoge
䱪	qoge
鮃	qogf
鱄	qogf
䱍	qogg
䱎	qogg
䲔	qogg
魳	qogh
䰽	qogh
鰽	qogj
䲋	qogj
鯃	qogk
鱷	qogk
鰏	qogl
鰿	qogm
魨	qogn
䱖	qogn
鱁	qogp
䲅	qogq
鯁	qogr
䱅	qogs
䱏	qogu
鮧	qogw
魱	qogx
鱺	qogx
鯄	qogy
䱙	qohc
鯡	qohd
䲐	qohe
鱥	qohh
鮛	qohi
鮎	qohk
鱸	qohl
鱋	qoho
鯱	qohw
鰬	qohy
匊	qoi
灳	qoi
烏	qoi
鳥	qoi
鮹	qoie
鱨	qoij
魦	qoit
鯋	qoit
鵿	qoja
鰻	qojc
魯	qojf
鯉	qojf
鰣	qojf
鯹	qojg
䱇	qojg
魝	qojh
鯷	qojh
鸔	qoji
鯧	qojj
鱪	qojj
鰛	qojl
鰨	qojn
鯣	qojr
鰑	qojr
鯤	qojx
鰅	qojy
䱒	qokc
鱓	qokf
鰐	qokn
鱢	qoks
䳅	qokw
鯝	qold
鰃	qole
鱞	qole
䴋	qole
魻	qolh
鰥	qoli
鱰	qolj
鮰	qolk
鰮	qoll
鰓	qoln
鰱	qolp
䱿	qolr
䱾	qolv
鮂	qolw
鱡	qomd
䱀	qomd
䱻	qome
鮋	qomg
鰂	qomj
㠀	qomj
鮦	qomk
鯛	qomk
䱩	qomn
鱧	qomu
䱺	qomu
魶	qomw
鰕	qonc
䱟	qond
䱬	qone
䱼	qone
䲁	qonf
鮙	qong
䱭	qong
䱴	qong
鯴	qonj
魢	qonn
鳦	qonn
䰲	qonn
鰼	qonr
鮅	qont
䲎	qont
鴃	qonw
鐒	qooe
䲏	qooe
鱗	qoog
鱅	qooh
鱇	qooi
鑅	qoos
䲈	qoos
錟	qooy
鯳	qooy
䱊	qooy
䳹	qopc
鰘	qopf
鰚	qopg
鰰	qoph
鯮	qopi
鰫	qopk
鯶	qopl
魫	qopq
鯇	qopq
鮟	qopv
鴥	qopw
鮀	qopx
鴕	qopx
䲬	qoqa
鮠	qoqb
鮣	qoqb
䳃	qoqb
鱌	qoqe
䱤	qoqe
鏻	qoqg
䲒	qoqg
䱢	qoqh
鮡	qoqi
鮈	qoqk
鰡	qoql
鮑	qoqn
䳈	qoqn
鰞	qoqo
鱻	qoqo
鵴	qoqo
鷠	qoqo
䱡	qoqo
䲆	qoqo
䲜	qoqo
鮸	qoqq
魩	qoqr
歍	qoqw
魡	qoqy
魬	qorc
䱝	qorf
鮊	qorg
鰉	qorg
鯑	qorh
䰺	qorh
鰁	qori
鮜	qork
䱑	qorr
鱳	qors
鯼	qort
鷈	qorw
䱄	qory
鯂	qosg
䱁	qosg
䰳	qosh
鰾	qosi
鯟	qosj
鯻	qosj
鱏	qosj
䱨	qosj
魺	qosk
鴚	qosk
鰊	qosl
䲚	qosm
䲇	qosp
䲷	qosu
鯠	qosw
鯆	qosy
魠	qota
鯚	qotb
䰿	qotb
䲙	qotb
鮓	qotf
鮢	qotf
䱰	qotf
鮏	qotg
䱃	qotg
䳀	qotg
鰤	qoth
鶳	qoth
鯀	qoti
鯏	qotj
鯯	qotj
鮥	qotk
鯌	qotk
鯦	qotk
鱎	qotk
鱵	qotk
鴼	qotk
鱕	qotl
㸋	qotl
魸	qotn
䰴	qotn
䲘	qotn
鰍	qoto
鯅	qotp
䱓	qotp
䲗	qots
鯓	qott
鰒	qott
䲄	qott
鮗	qotu
鴤	qotu
鯘	qotv
䱕	qotx
穌	qoty
魞	qoty
䰻	qoty
䳗	qoty
䳘	qoty
魚	qou
鮩	qoua
䱹	qoua
䱧	qoub
鑆	qouf
鱂	qouf
鱒	qouf
鏷	qoug
鰌	qoug
鱃	qoug
鮮	qouh
鱆	qouj
鱛	qouj
䲕	qouj
鱔	qouk
鮵	qouq
鮫	qour
鮷	qout
鯜	qouv
鱶	qouv
鐮	qouw
鰜	qouw
鰦	qoux
鸃	qouy
䲑	qouy
鯽	qovb
鮼	qovc
鱘	qovf
鏞	qovh
鯞	qovh
鏮	qovi
鵦	qovi
䱚	qovi
鱐	qovj
鎕	qovk
鮉	qovk
鮶	qovk
鯔	qovl
鱲	qovn
鰎	qovp
䲃	qovs
魛	qovt
鯩	qowa
鳧	qowb
魿	qowc
鱍	qowc
䰸	qowc
鮲	qowd
鯸	qowd
䳧	qowd
鮒	qowf
鰶	qowi
魪	qowj
鱠	qowj
鮯	qowk
䱽	qowk
鯰	qown
䰼	qown
䱵	qown
鯾	qowr
鮴	qows
鮽	qows
鰷	qows
鵌	qows
䱔	qowt
魵	qowv
䲓	qoww
魤	qowx
魜	qowy
鮘	qowy
鴏	qowy
鵻	qowy
䱦	qowy
鱜	qoxb
䱂	qoxe
䱲	qoxe
鱦	qoxg
鮄	qoxj
鮨	qoxj
鑣	qoxo
鰯	qoxu
鏕	qoxx
魮	qoxx
麁	qoxx
䥝	qoxx
鈥	qoy
銤	qoy
鯿	qoya
鯙	qoyb
䱶	qoyb
䙚	qoye
䱣	qoyf
鱣	qoyg
䱱	qoyh
䲂	qoyh
鯨	qoyi
鱭	qoyj
鯍	qoyk
鰝	qoyk
魲	qoyn
䰶	qoyn
魴	qoyt
鷻	qoyt
䲱	qoyt
鯲	qoyu
魧	qoyw
鮌	qoyx
魰	qoyy
鰟	qoyy
鑳	qpah
鑧	qpay
鋐	qpdc
鎋	qpdk
䥱	qpeo
䥂	qpfe
錝	qpfi
鋎	qpfq
鎵	qpge
鍹	qpgg
䥾	qpgg
錠	qpgh
鑌	qpgm
鏔	qpgw
鍕	qplh
錧	qpng
鑏	qpns
䤹	qpoc
鋺	qpqb
鈂	qpqn
䥉	qpqy
䤩	qpta
銨	qpvg
鑔	qpwi
鏥	qpwj
镕	qpwk
鎔	qpwk
鑹	qpwn
䤟	qpwn
䥃	qpwy
鉈	qpxn
鎺	qpyg
錉	qqaj
銽	qqak
卶	qqbh
䤝	qqbh
銫	qqcn
鈎	qqcy
䤥	qqdb
䫂	qqdm
㷇	qqdo
錎	qqeg
㩼	qqfc
夡	qqfk
鍂	qqg
匇	qqi
鉨	qqiy
銚	qqiy
銁	qqjg
㚌	qqjs
鐌	qqke
鉤	qqkg
銘	qqkg
㚍	qqkm
鋔	qqkq
鑱	qqky
镵	qqky
㚋	qqmk
翗	qqng
鉋	qqnn
铇	qqnn
鑥	qqoj
鎢	qqoy
鵭	qqoy
迻	qqpi
夠	qqqk
鉹	qqqy
鍃	qqrn
鍯	qqrn
䥼	qqrt
鉚	qqtb
鋾	qqtb
鈞	qqug
憌	qqun
郺	qqvc
錚	qqvh
欽	qqwy
釸	qqy
鍧	qqyg
鎦	qqyl
㚊	qqyw
釣	qqyy
胷	qrbe
鍐	qrbt
鈑	qrcy
鈲	qrcy
䤭	qrdh
甮	qrej
䤨	qrey
鍎	qrfh
锧	qrfm
鉑	qrg
䝆	qrge
鍠	qrgg
锽	qrgg
銗	qrgk
䥿	qrgq
釿	qrh
䀜	qrhf
釽	qrhy
匁	qri
䤼	qriy
曶	qrjf
㫚	qrjf
䥟	qrjn
錦	qrmh
鎎	qroy
鍁	qrqw
鑕	qrrm
鎩	qrsc
錍	qrtf
㬟	qruj
鋲	qrwy
鑠	qrxs
怱	qryn
䥞	qryt
䥮	qsab
鄡	qsbh
鏢	qsfi
鎛	qsfy
镈	qsfy
鉢	qsgg
釘	qsh
錬	qsjg
鐔	qsjh
鈳	qskg
鋉	qskg
鎶	qskk
鏉	qskw
鍊	qslg
錰	qsoy
䥔	qsoy
鑻	qsrr
梟	qsu
䥑	qswq
錸	qsww
鈢	qsy
鋪	qsy
鉥	qsyy
㹽	qtaa
獲	qtac
獏	qtad
㺇	qtad
獴	qtae
㺃	qtak
㺝	qtal
狘	qtan
獦	qtan
䤜	qtan
玂	qtar
犽	qtat
獚	qtaw
㺦	qtbg
猻	qtbi
㺈	qtbj
乮	qtbn
犼	qtbn
鉇	qtbn
銹	qtbt
狓	qtby
㺛	qtca
㺑	qtce
㹩	qtcf
獝	qtck
獁	qtco
猰	qtdd
狉	qtdg
狜	qtdg
銛	qtdg
铦	qtdg
鋒	qtdh
㺡	qtdh
獂	qtdi
鑙	qtdj
㹮	qtdj
鐈	qtdk
㺂	qtdk
懖	qtdn
鏠	qtdp
獉	qtdt
獶	qtdt
獿	qtdt
狹	qtdw
猉	qtdw
犾	qtdy
狵	qtdy
鉃	qtdy
猺	qteb
猨	qtec
獀	qtec
猙	qteh
㹢	qtek
獡	qteo
㺔	qteo
㺞	qtew
匋	qtfb
㹲	qtfb
銩	qtfc
㹤	qtfc
鍤	qtfe
鈓	qtfg
釺	qtfh
狋	qtfi
獳	qtfj
狤	qtfk
鋯	qtfk
獖	qtfm
鑽	qtfm
遙	qtfp
鋌	qtfp
㺚	qtfp
獟	qtfq
銑	qtfq
犲	qtft
狫	qtfx
銖	qtfy
㺢	qtfy
㹵	qtga
錘	qtfa
鍾	qtgf
夝	qtgg
狟	qtgg
鉎	qtgg
犻	qtgh
鈝	qtgh
㹳	qtgk
㺓	qtgm
㤮	qtgn
㹠	qtgn
鑂	qtgo
鵟	qtgo
獮	qtgr
㹬	qtgr
㹴	qtgr
獓	qtgt
㹫	qtgw
鉄	qtgy
㺣	qtha
玃	qthc
鍛	qthc
猅	qthd
鈼	qthf
獩	qthh
㹿	qthj
䥷	qthj
獹	qthl
鎴	qthn
鋋	qthp
鎳	qths
䥡	qths
猇	qthw
猟	qtig
㹺	qtij
㹰	qtiq
猀	qtit
獙	qtit
獌	qtjc
猂	qtjf
狚	qtjg
鋓	qtjh
猲	qtjn
鏫	qtjs
鍑	qtjt
㹭	qtjt
猑	qtjx
㺗	qtkf
鉻	qtkg
狆	qtkh
㹱	qtkh
㺧	qtkk
玁	qtkt
獧	qtle
獨	qtlj
鏓	qtln
獑	qtlr
㺏	qtlv
鎞	qtlx
玀	qtly
鐭	qtmd
㹧	qtmd
㺜	qtme
㹨	qtmg
㹪	qtmg
鉓	qtmh
狦	qtmj
猯	qtmj
匔	qtmk
狪	qtmk
猧	qtmk
銄	qtmk
銵	qtmt
鎫	qtmt
䥩	qtmt
猠	qtmw
匑	qtmx
狽	qtmy
獕	qtmy
⺈	qtn
猳	qtnc
㺒	qtne
峱	qtnm
釳	qtnn
鎚	qtnp
㺖	qtnt
㹟	qtnw
狔	qtnx
㺟	qtny
獛	qtog
獜	qtog
㺎	qtoh
鐇	qtol
悐	qton
鏭	qton
獷	qtow
㹹	qtow
鍬	qtoy
猔	qtpi
獱	qtpm
㺙	qtpm
獰	qtps
猽	qtpu
狖	qtpw
㺍	qtpw
㺠	qtpy
㹝	qtqa
㺅	qtqd
狝	qtqi
狣	qtqi
鑗	qtqi
狥	qtqj
㺀	qtqn
㹼	qtqo
犳	qtqy
㺥	qtqy
猈	qtrf
獆	qtrf
獔	qtrf
狛	qtrg
狶	qtrh
㹞	qtrh
㹸	qtrq
狾	qtrr
猣	qtrt
獥	qtrt
鋨	qtry
猼	qtsf
獺	qtsm
鏼	qtsm
猍	qtsw
狇	qtsy
狏	qttb
䥏	qttb
狧	qttd
狅	qttf
獋	qttf
狌	qttg
獅	qtth
猘	qttj
狢	qttk
獢	qttk
㹾	qttk
㺕	qttl
犵	qttn
狿	qttp
㹶	qttp
㹣	qttu
㹻	qttv
獇	qtuc
獞	qtuf
䤣	qtuf
猶	qtug
獈	qtul
猐	qtun
㺊	qtun
㺌	qtuw
鉖	qtuy
錗	qtvg
㹦	qtvk
獵	qtvn
㺁	qtvr
㺐	qtvs
犱	qtvy
狑	qtwc
猤	qtwd
㺤	qtwg
鏦	qtwh
猦	qtwj
獪	qtwj
㺄	qtwj
獊	qtwk
鋵	qtwn
㺋	qtwn
㺘	qtwo
㹯	qtws
獫	qtww
猚	qtwy
狕	qtxe
猭	qtxe
獼	qtxr
鋂	qtxy
鉌	qty
猵	qtya
獄	qtyd
猏	qtye
獽	qtye
釒	qtyg
㹥	qtyg
犿	qtyh
猄	qtyi
㺆	qtym
鸑	qtyo
獤	qtyt
犺	qtyw
㹡	qtyx
釞	qtyy
鎈	quag
鉼	quah
鎙	qube
鎹	qudp
鑨	qued
鐗	queg
鎆	quej
鐩	quep
斘	qufh
鈄	qufh
鉝	qug
鍆	qug
鐦	quga
錈	qugb
鎂	qugd
鉡	qugh
鋅	quh
鐘	qujf
鐧	qujg
鏱	qujh
鐿	qujn
鏡	qujq
錇	qukg
䥨	qukk
鋭	qukq
鏳	qulj
錓	qunn
鐠	quoj
鏘	quqf
鉸	qury
䥖	qusd
鐏	qusf
鑭	qusl
䥜	qusy
鏟	qutg
䥥	qutw
鐥	quuk
䦅	quuk
鎌	quvw
鎰	quwl
㔨	quxe
鉳	quxn
銻	quxt
鎡	quxx
镃	quxx
鐞	qvaf
鏽	qvfj
釹	qvg
銉	qvgh
鍿	qvgl
鍵	qvgp
録	qviy
鏁	qvjs
鉊	qvkg
銣	qvkg
錙	qvlg
鑞	qvln
镴	qvln
鎻	qvmy
釚	qvn
鋟	qvpc
釖	qvt
勼	qvv
匓	qvwc
銀	qvy
釰	qvyy
釻	qvyy
釼	qvyy
䤦	qway
鳬	qwb
鎓	qwcn
鈆	qwcy
鈠	qwcy
鉁	qwet
鉜	qwfy
錀	qwga
鑰	qwga
鍨	qwgd
銓	qwgg
鍮	qwgj
匌	qwgk
鉿	qwgk
鎿	qwgr
鐙	qwgu
鐱	qwgw
鎀	qwhe
鏅	qwhe
勽	qwi
鉩	qwiy
鉛	qwkg
銳	qwkq
釠	qwn
鍭	qwnd
匃	qwnv
銝	qwsy
䤪	qwsy
銋	qwtf
鈖	qwvt
銼	qwwf
鑯	qwwg
䥘	qwwj
鋊	qwwk
鏺	qwxc
鈋	qwxn
釟	qwy
鎸	qwyb
鈴	qwyc
鎨	qwyf
錐	qwyg
鋡	qwyk
鎗	qwyk
鈐	qwyn
錜	qwyn
鐫	qwyn
鐎	qwyo
鏶	qwys
釩	qwyy
䤸	qxey
鐑	qxfk
鈏	qxhh
鈟	qxhh
鎭	qxhw
銯	qxiy
錄	qxiy
鉘	qxjh
鐨	qxjm
鏹	qxkj
鏆	qxmy
匂	qxv
鈚	qxxn
鍇	qxxr
鐖	qxxw
鉧	qxy
錞	qybg
䥋	qybo
鐓	qybt
錥	qyce
鋶	qyck
銃	qycq
裊	qyeu
銥	qyey
鎄	qyey
䚻	qyf
鉒	qygg
夊	qyi
鍄	qyiy
鑇	qyjg
鑲	qyke
鈰	qymh
鎬	qymk
鍽	qyna
錑	qynd
䥰	qynj
釯	qynn
䥇	qynn
䦂	qynn
鈩	qynt
匄	qynv
䤤	qynw
粂	qyou
䢣	qypd
鈁	qyt
鍦	qytb
毈	qytc
鏃	qytd
銂	qyth
鏇	qyth
䌛	qyti
贕	qytm
㤻	qytn
邎	qytp
鏑	qyud
鍗	qyuh
鎊	qyuy
鄮	qyvb
鎯	qyvb
鹠	qyvg
劉	qyvj
貿	qyvm
鶹	qyvo
斵	qyvr
鋃	qyvy
錊	qywf
鈧	qywn
䤳	qywy
鏲	qyxg
鉉	qyxy
鈫	qyy
擛	raas
搑	rabg
掿	radk
擆	rafj
撶	ragg
皣	ragg
捓	rahb
摼	rahf
挋	rahh
㩜	rahl
攬	rahq
㧎	raht
擓	raiy
擖	rajn
掝	rakg
㨷	rakg
摳	rakk
㩰	raks
擹	rakw
攤	raky
㩲	raky
㩢	ralw
搆	ramf
㧜	ramh
撗	ramw
㨅	ramw
摃	ramy
㨺	ramy
抴	rann
㩚	rape
㨲	raps
摕	raqh
撍	raqj
㨚	raqj
擏	raqt
擭	rawc
攃	rawi
㨤	rawy
攝	rbbb
㨕	rbcl
掫	rbcy
撱	rbde
挕	rbg
邤	rbh
㧄	rbh
摂	rbiy
掹	rblg
扡	rbn
兇	rbqb
挅	rbsy
搎	rbti
㚇	rbwt
扱	rbyy
摻	rcce
㩹	rllg
撡	rccn
㧐	rccy
撪	rcdl
㨧	rcdl
㨢	rcex
㧠	rciy
掻	rcjy
皅	rcn
抁	rcqn
㿝	rcu
捘	rcwt
払	rcy
瓥	rcyj
㼖	rcyj
瓟	rcyn
㼉	rcyq
㼎	rcyr
㼒	rcyr
㼓	rcyw
扠	rcyy
瓝	rcyy
㼌	rcyy
㨊	rdae
敎	rdbt
㕁	rdcb
抜	rdcy
㩡	rddd
郩	rdeb
殽	rdec
擾	rdet
掁	rdey
捹	rdfa
䣗	rdfb
搙	rdff
㨒	rdff
拝	rdfh
撦	rdfj
䫧	rdfm
鷎	rdfo
䳲	rdfo
䚌	rdfq
摦	rdfy
㨔	rdgk
搣	rdgo
揻	rdgv
拵	rdhb
揳	rdhd
抷	rdhg
摵	rdhi
㧵	rdhk
㩨	rdhn
㨹	rdhv
抔	rdhy
揼	rdiy
擫	rdjd
㨎	rdmd
㹷	rdmd
抪	rdmh
㡍	rdmh
㧫	rdmj
鵗	rdmo
瓻	rdmy
頎	rdmy
拋	rdne
拻	rdoy
摤	rdrr
挷	rdtb
攊	rdth
㿨	rdth
㚖	rdu
摏	rdwe
㿤	rdwj
揕	rdwn
搸	rdwt
挾	rdww
掑	rdwy
㧋	rdy
㧔	rdy
扙	rdyy
揑	reag
捊	rebg
拹	reee
搚	reee
掤	reeg
搯	reeg
揺	refb
抈	reg
㧮	reg
抯	regg
攑	regg
㩮	regr
覛	rehq
拁	rekg
皭	relf
㩊	relf
㩱	relf
㧌	ren
㿞	ren
皧	rept
掜	reqn
㩭	rerb
攪	rerq
採	resy
劤	ret
劧	ret
劰	ret
扐	ret
㔕	ret
撝	reto
挼	revg
掙	revh
㨙	rexd
㩥	rfag
擮	rfay
搕	rfcl
抎	rfcy
抾	rfcy
擩	rfdj
掛	rffh
摴	rffn
撓	rffq
皢	rffq
扗	rfg
拑	rfg
扞	rfh
㨁	rfhg
攧	rfhm
鶞	rfho
搷	rfhw
瞂	rfhy
皁	rfj
撠	rfja
㨴	rfjn
㨬	rfke
擡	rfkf
擷	rfkm
擜	rfmd
揇	rfmf
乕	rfmh
貭	rfmi
逓	rfmp
擣	rfnf
㿧	rfnf
扝	rfnn
捇	rfoy
挬	rfpb
撎	rfpu
抏	rfqn
搘	rftj
㨋	rftj
㧯	rftx
撻	rfup
㩕	rfwc
掕	rfwt
皬	rfwy
抺	rfy
挵	rgah
扽	rgbn
挃	rgcf
捯	rgcj
㨖	rgct
巵	rgcv
㩑	rgdd
㧷	rgdk
掅	rgeg
皘	rgeg
㧻	rgey
㧼	rgey
掗	rgfg
氬	rgfg
扜	rgfh
抂	rgg
攆	rggl
攅	rggm
摫	rghq
皝	rgiq
捄	rgiy
摶	rgjf
㩅	rghl
皩	rgjq
挭	rgjr
郈	rgkb
劶	rgke
垕	rgkf
搹	rgkh
㨽	rgkj
揊	rgkl
㩖	rglg
㧊	rgmh
抦	rgmw
氞	rgmw
攦	rgmx
掚	rgmy
皟	rgmy
㧚	rgny
㼟	rgny
挜	rgog
搢	rgoj
挒	rgqj
扤	rgqn
䳨	rgqo
皌	rgsy
挳	rgva
氫	rgva
捿	rgvv
擟	rgwr
㨞	rgxi
挗	rgxw
㪂	rhcy
掯	rheg
摣	rheg
㩵	rhgd
據	rhge
挊	rhgh
捗	rhht
拤	rhhy
㩴	rhhy
掓	rhic
擄	rhle
攎	rhll
攄	rhln
㲶	rhlo
揁	rhmy
㩬	rhoa
挸	rhqn
㩀	rhqy
摢	rhtf
㨿	rhtw
㨗	rhvh
䴘	rhwg
䫢	rhwm
䖊	rhwn
䖐	rhwn
鷉	rhwo
遞	rhwp
虒	rhwv
歋	rhww
皉	rhxn
㧗	rhxn
㸕	rhyc
坕	rhyf
爮	rhyn
㨜	rhyy
㧟	rian
㲵	ried
㣎	rier
㣐	riet
皐	rifj
翶	rifn
挄	rigq
㿠	rigq
挱	riit
㧺	rijg
摚	ripf
擋	ripl
攩	ripo
㿩	ripo
撹	ripq
撐	ript
灥	riri
楽	risu
挘	rite
毮	rite
㨘	rith
㩧	rjai
氜	rjd
㩎	rjed
擝	rjel
捚	rjfg
皔	rjfh
抇	rjg
㧹	rjgf
揚	rjgr
氱	rjgr
刏	rjh
捜	rjhc
氠	rjhk
㨪	rjiq
摱	rjlc
揾	rjlg
搨	rjng
捑	rjny
㿣	rjqn
掦	rjqr
掲	rjqx
捰	rjsy
㨫	rjtl
掍	rjxx
撔	rjyi
擑	rkby
挰	rkgg
㲴	rkhk
撌	rkhm
撣	rkkf
㲷	rkkf
捛	rkkg
損	rkmy
拀	rkqn
抧	rkwy
摑	rlag
擺	rlcx
㧽	rldg
㧢	rldy
畠	rlf
擇	rlff
搟	rlfh
㩏	rlfo
揋	rlge
㨡	rlge
㩛	rlgf
捙	rlh
攌	rlle
攂	rlll
㩸	rlly
揌	rlny
摙	rlpy
擉	rlqj
斶	rlqj
摲	rlrh
摟	rlvg
擻	rlvt
搵	rlwl
氳	rlwl
攞	rlxy
擃	rmae
捵	rmaw
㨏	rmdo
抰	rmdy
搰	rmeg
抩	rmfg
皗	rmfk
㨄	rmfk
㧇	rmgg
挏	rmgk
皚	rmgu
㨟	rmgu
㧆	rmhh
緜	rmhi
㩄	rmln
攖	rmmv
撾	rmnp
㧏	rmry
掆	rmum
㩗	rmwb
氝	rmwi
攜	rmwk
抐	rmwy
皠	rmwy
㩔	rnac
㨉	rnaj
捤	rnen
扟	rnfh
挧	rng
䎅	rng
揯	rngg
搄	rngg
揟	rnhe
㧃	rnhh
忥	rni
㨝	rnie
摨	rnig
癿	rnn
挶	rnnk
㩣	rnpl
乺	rnrn
㧙	rntt
㣻	rnu
搱	rnuh
摎	rnwe
紥	rnxi
屔	rnxn
抳	rnxn
抋	rny
択	rnyy
擴	roaw
拡	rocy
氣	roi
撈	rooe
攚	rook
㩞	roos
掞	rooy
撛	roqg
掋	roqy
攠	rosd
擵	rosr
㨩	rotp
擈	rouf
撲	roug
掶	rovw
捬	rowf
攗	roxo
皫	roxo
㩠	roxo
攈	roxt
攟	roxt
摝	roxx
攐	rpae
㩙	rpaf
攓	rpah
㩷	rpao
㩟	rpas
㩃	rpau
廹	rpd
搳	rpdk
㨳	rpdk
攇	rpdn
捖	rpfq
掟	rpgh
擯	rpgm
㨠	rpju
揮	rplh
捾	rpng
㨸	rpnm
擰	rpns
捥	rpqb
抌	rpqn
㧲	rpsy
挓	rpta
揢	rptk
揬	rpwd
搾	rpwf
㨓	rpwg
摍	rpwj
搈	rpwk
㩈	rpwk
抭	rpwn
攛	rpwn
摉	rpwq
搉	rpwy
搲	rpwy
攨	rpwy
㧒	rpwy
㩁	rpwy
㿥	rpwy
拕	rpxn
捪	rqaj
扺	rqan
皃	rqb
搊	rqbt
鬾	rqcc
鬽	rqce
䰦	rqcf
魊	rqcg
魓	rqcg
䰡	rqcg
䰠	rqch
䰯	rqch
魒	rqci
魀	rqcj
䰬	rqck
䫥	rqcm
魆	rqcn
魖	rqco
䰫	rqcq
鬿	rqcr
䰢	rqcs
魌	rqcw
魐	rqcw
魕	rqcw
䰧	rqcw
抅	rqcy
魋	rqcy
魎	rqcy
䰮	rqcy
㧪	rqdb
撚	rqdo
擔	rqdy
㩂	rqef
捔	rqeh
捦	rqg
搩	rqgs
㿡	rqiu
㧦	rqjg
㐝	rqkn
攙	rqky
換	rqmd
搗	rqmh
擼	rqoj
摀	rqoy
㨶	rqoy
䳆	rqoy
撳	rqqw
拸	rqqy
揔	rqrn
㧾	rqrn
搖	rqtb
㧕	rqtb
抣	rqug
扻	rqwy
㰟	rqwy
揈	rqyg
㨱	rqyg
㨨	rqyl
扚	rqyy
㨑	rrbt
㿱	rrbu
鋬	rrcq
㧓	rrcy
皞	rrdf
硩	rrdf
爼	rreg
挀	rrey
埑	rrff
揗	rrfh
拞	rrg
㿟	rrg
揘	rrgg
㧨	rrgk
抙	rrh
斦	rrh
䀸	rrhf
擨	rrhw
気	rri
皡	rrif
晢	rrjf
啠	rrkf
捳	rrmh
劕	rrmj
質	rrmu
㧉	rrn
乴	rrnb
悊	rrnu
烲	rrou
焎	rrou
銴	rrqf
㨮	rrqq
皛	rrrf
皨	rrrf
掱	rrrj
㩫	rrrm
㸚	rrrr
摋	rrsc
梊	rrsu
娎	rrvf
䭁	rrwv
捠	rrwy
䋢	rrxi
擽	rrxs
皪	rrxs
裚	rrye
撽	rryt
皦	rryt
氥	rsd
摽	rsfi
拪	rsg
氭	rsjd
㨂	rsjg
撢	rsjh
抲	rskg
捒	rskg
揦	rskj
攋	rskm
摗	rskw
揀	rslg
拺	rsmn
㩒	rssi
搮	rssy
㨆	rssy
閷	rsuw
殺	rswc
剎	rsyj
㩤	rsyt
弒	rsyy
抍	rtah
扥	rtan
逰	rtbp
㧞	rtdc
捀	rtdh
撟	rtdk
摓	rtdp
擌	rtdw
扷	rtdy
㪏	rtfc
㩐	rtff
捁	rtfk
攢	rtfm
䫌	rtfm
鵯	rtfo
㧥	rtfq
㧣	rtfy
㼰	rtfy
揰	rtgf
挿	rtgh
揷	rtgh
撫	rtgo
㩶	rtgr
龵	rtgt
抶	rtgy
搝	rthd
拃	rthf
皥	rthf
揝	rthj
扸	rthn
挻	rthp
摥	rtjr
挌	rtkg
摠	rtln
擙	rtmd
㧶	rtmt
㧰	rtni
扢	rtnn
搥	rtnp
抸	rtpy
皒	rtry
㧴	rtry
㩍	rtsm
⺁	rtt
擶	rtuj
擳	rtvb
捼	rtvg
㨀	rtvg
摐	rtwh
撘	rtwk
拠	rtwn
㩯	rtxi
挴	rtxy
乂	rty
敀	rty
㐅	rty
扖	rtyy
皏	ruah
㨰	ruce
攏	rued
撊	rueg
揃	ruej
㨵	ruev
捫	rug
捲	rugb
撋	rugg
㨾	rugi
搼	rugr
攁	rugv
㩘	rugy
撯	ruhg
摬	rujq
搃	rukn
捝	rukq
掽	ruog
摪	ruqf
挍	rury
擲	rusb
揂	rusg
攔	rusl
摌	rutg
擱	rutk
搤	ruwl
㨛	ruwy
揹	ruxe
兠	ruxq
挮	ruxt
撏	rvaf
摡	rvaq
揤	rvbh
㩇	rvfg
㩋	rvfj
挦	rvfy
揵	rvgp
捸	rviy
摷	rvjs
擸	rvln
扏	rvn
慇	rvnn
㐆	rvnv
掃	rvph
㧅	rvt
拫	rvy
扨	rvyy
捴	rwcn
㨣	rwcn
抮	rwet
摖	rwfi
捨	rwfk
掄	rwga
揜	rwga
掵	rwgb
㧩	rwgh
㩉	rwgn
捈	rwgs
撜	rwgu
撿	rwgw
扴	rwjh
挩	rwkq
㨐	rwks
挆	rwsy
拰	rwtf
㒵	rwu
摿	rwuj
扵	rwuy
㧳	rwvr
攕	rwwg
㧿	rwwh
撥	rwxc
皊	rwyc
㩳	rwyc
㨦	rwyc
搇	rwye
㔼	rwyf
搶	rwyk
㩦	rwyk
扲	rwyn
擕	rwyn
撨	rwyo
墍	rxaf
曁	rxag
旣	rxaq
槩	rxas
皀	rxb
卽	rxbh
皍	rxbj
㩪	rxdm
攭	rxej
㩩	rxim
㩌	rxjm
摾	rxkj
㨥	rxmw
摜	rxmy
㧈	rxn
抝	rxnn
撧	rxqc
擬	rxth
樂	rxxs
㨯	rybb
㨃	rybg
㧸	rybh
撴	rybt
㿭	ryby
㧧	ryck
㧤	rycq
挔	ryey
攍	ryey
㧑	ryey
抃	ryhy
㩆	ryiy
擠	ryjg
㨈	ryjg
䟟	rykh
皜	rymk
揙	ryna
㨭	rync
搧	rynn
㧖	rynn
㧡	rynw
㩝	rype
揨	ryps
㰾	ryqw
摛	ryrc
攡	ryry
㧍	ryt
揓	rytb
䚫	ryte
㦘	rytn
鸄	ryto
譥	ryty
揥	ryuh
擿	ryup
搒	ryuy
捽	rywf
撁	ryxg
擁	ryxy
抆	ryy
欌	saah
櫙	saak
栻	saay
棧	saay
榵	sabg
桏	sabh
楛	sadg
楉	sadk
㭜	sadt
橵	saet
杢	saf
覇	safe
㮖	safh
覉	safk
㯼	safl
覊	safo
樲	safy
樺	sagg
橫	sagw
㭨	sahb
樫	sahf
栕	sahh
檻	sahl
㰓	sahm
欖	sahq
㰖	sahq
枒	saht
欂	saif
橗	saje
棤	sajg
椻	sajv
棫	sakg
樞	sakk
櫃	sakm
欟	sakq
權	saky
㰙	saky
㭱	salh
櫣	salp
櫗	salw
楧	samd
構	samf
槓	samy
樠	samy
枻	sann
楪	sans
㯴	sapk
㮠	saps
㯂	saqh
槆	saqj
橬	saqj
檧	saqn
㯳	saqt
㰛	sars
㯵	satf
樥	sath
㮱	satq
㮜	sauf
欗	saul
櫹	savj
檴	sawc
欍	sawe
﨓	sawf
櫒	sawi
榙	sawk
檋	sawl
櫵	sawo
㮪	saws
㯣	saws
椛	sawx
栱	sawy
㯜	sayf
㭶	sayt
杙	sayy
欇	sbbb
棷	sbcy
橢	sbde
櫇	sbdm
㰐	sbdp
杍	sbg
栮	sbg
邒	sbh
郙	sbh
䢶	sbh
㮀	sbib
極	sbkg
檉	sbkg
柮	sbmh
杝	sbn
㭯	sbnn
樄	sbsj
桗	sbsy
㭁	sbt
槂	sbti
㯁	sbuk
柀	sby
㭓	scah
棳	sccc
槮	scce
槡	sccs
椮	scde
桳	scdf
㮥	scdl
樋	scep
枱	sckg
㮭	sclf
櫲	scne
壄	scnf
楙	scns
楺	scns
㮊	scns
柕	scnt
㮘	scnt
榪	scoy
㭇	scqn
桙	sctg
㮻	scyj
楕	sdae
檶	sdak
櫔	sday
枙	sdbn
柭	sdcy
㰁	sddd
㮋	sdeb
栯	sdeg
楜	sdeg
櫌	sdet
棖	sdey
桭	sdfe
楏	sdff
槈	sdff
櫉	sdff
㮈	sdfi
桍	sdfn
槬	sdfy
㭅	sdg
椷	sdgk
楲	sdgv
栫	sdhb
柸	sdhg
㭋	sdhh
㰗	sdhh
桮	sdhk
㮎	sdhl
櫘	sdhn
㮮	sdhr
榎	sdht
槥	sdhv
栢	sdjg
㭺	sdjn
槗	sdkk
㮌	sdlf
㮕	sdmd
柨	sdmh
栭	sdmj
頂	sdmy
䙴	sdnb
㮷	sdnj
遷	sdnp
榞	sdri
樉	sdrr
㮟	sdsy
梼	sdtf
櫪	sdth
䙲	sdu
橭	sduh
橑	sdui
樁	sdwe
樭	sdwf
櫀	sdwi
㯕	sdwr
㯦	sdws
梜	sdww
杕	sdy
枤	sdy
檓	seac
檼	sean
棴	sebc
栛	seee
槄	seeg
㭩	sefy
枂	seg
楥	segc
査	segf
柤	segg
櫸	segg
欅	segr
㮴	sehc
㯒	sehq
枆	sen
橓	sepg
棿	seqn
㰒	serb
棌	sesy
朸	set
榣	setb
櫾	seti
㮳	seud
橳	seue
桵	sevg
楰	sewy
榽	sexd
欛	sfae
㰇	sfag
枿	sfah
橨	sfam
桟	sfay
榼	sfcl
㟚	sfcm
枟	sfcy
㭕	sfcy
檽	sfdj
垔	sff
橒	sffc
䙵	sfff
橈	sffq
㯘	sffw
㭙	sffy
㯧	sfhk
㰜	sfhm
䚈	sfhq
槙	sfhw
勡	sfie
彯	sfie
㲡	sfie
隸	sfii
飄	sfij
顠	sfim
翲	sfin
歀	sfiw
柡	sfiy
㼼	sfiy
橶	sfja
榸	sfjf
檊	sfjf
枾	sfjg
榬	sfke
樹	sfkf
檯	sfkf
橲	sfkk
櫺	sfkk
欞	sfkw
櫝	sflm
㯖	sfln
檮	sfnf
㭏	sfnh
杇	sfnn
梽	sfny
桲	sfpb
㯛	sfpg
㮦	sfpi
杬	sfqn
歅	sfqw
㮄	syqy
楳	sfsy
㭳	sftb
榰	sftj
尃	sfu
橽	sfup
樰	sfvg
㯪	sfwc
檣	sfwk
㰊	sfwo
槸	sfwy
㰌	sfwy
㭑	sfy
醆	sgaa
䤊	sgab
䤓	sgae
枅	sgah
梇	sgah
㭢	sgaj
䤐	sgaj
醧	sgak
䤀	sgak
䣰	sgan
醼	sgao
䤑	sgaw
䣧	sgay
䣬	sgay
䤍	sgay
䣵	sgbg
杶	sgbn
䣲	sgca
醊	sgcc
醦	sgce
椡	sgcj
䤎	sgck
㮹	sgct
㰉	sgct
酭	sgde
䤄	sgdf
醎	sgdk
醃	sgdn
㮇	sgdn
䤁	sgdn
䣭	sgdy
䣮	sgdy
酻	sgeb
醙	sgec
釂	sgef
棈	sgeg
䣯	sgeg
酕	sgen
㯌	sgep
䣦	sget
椓	sgey
㭬	sgey
䣫	sgfc
醻	sgff
椏	sgfg
杅	sgfh
醏	sgfj
醹	sgfj
醽	sgfk
醘	sgfl
酛	sgfq
䤂	sgfs
酑	sggf
䣪	sggh
醩	sggj
䣿	sggl
櫕	sggm
䣩	sggn
釃	sggx
酜	sggy
柾	sghg
覀	sghg
酟	sghk
㯊	sgho
槻	sghq
䤏	sghr
朩	sghy
梂	sgiy
槫	sgjf
䤖	sgji
橊	sgjl
醖	sgjl
桺	sgjn
橞	sgjn
欜	sgke
䣺	sgke
槅	sgkh
櫮	sgkk
㮺	sgkk
楅	sgkl
釅	sgkt
梪	sgku
醳	sglf
橿	sglg
醞	sgll
醲	sgme
杮	sgmh
醠	sgml
㯾	sgmp
欐	sgmx
樍	sgmy
翉	sgng
䣳	sgnk
䤉	sgnl
酦	sgny
㼗	sgny
釄	sgod
醿	sgoi
榗	sgoj
醈	sgoo
醾	sgoo
㶾	sgou
䤇	sgpc
逎	sgpd
酧	sgpf
醡	sgpf
䣾	sgpg
醓	sgpl
酖	sgpq
醄	sgqb
栵	sgqj
䣱	sgqk
杤	sgqt
醜	sgrc
䣴	sgrq
䤕	sgrs
醥	sgsi
醰	sgsj
酠	sgsk
醂	sgss
枺	sgsy
酺	sgsy
䣨	sgta
䣶	sgtd
䣷	sgtf
醝	sgua
醸	sgue
酙	sguf
䤃	sguj
醷	sgun
梾	sgus
桱	sgva
酔	sgvf
醁	sgvi
棲	sgvv
䣹	sgwa
酘	sgwc
醱	sgwc
䤆	sgwd
酫	sgwg
䤘	sgwg
䤅	sgwj
䣻	sgwk
䤌	sgwk
䤈	sgwl
醗	sgwq
檷	sgwr
醶	sgww
醀	sgwy
酳	sgxe
枑	sgxg
榡	sgxi
䤙	sgxj
䣥	sgxn
桋	sgxw
䤒	sgxw
枎	sgy
醨	sgyc
釀	sgye
䣼	sgyi
醕	sgyj
酼	sgyk
棑	shdd
㯇	shdf
檅	shdh
樝	sheg
杫	shg
㯫	shge
桛	shgh
欔	shhc
㰋	shhm
欋	shhy
槕	shjs
枮	shkg
㯭	shle
櫨	shll
櫖	shln
樐	shlo
楨	shmy
檙	shnn
梘	shqn
㯉	shtf
椃	shwn
椇	shwy
橴	shxi
榩	shyy
﨔	sigr
㭼	sijg
㭻	simk
檔	sipl
欓	sipo
橖	sips
橕	sipt
㭞	site
㮐	sith
桜	sivg
樑	sivs
㭂	siy
㮿	sjag
樶	sjbc
㭴	sjcf
東	sjd
榯	sjff
梩	sjfg
桿	sjfh
皶	sjgb
棏	sjgf
柦	sjgg
棩	sjgg
㮛	sjgh
鸉	sjgo
楊	sjgr
㼯	sjgy
柛	sjhh
䚓	sjhq
榥	sjiq
椙	sjjg
橸	sjjj
螙	sjju
槾	sjlc
榅	sjlg
栧	sjnt
㭿	sjqb
楬	sjqn
鶇	sjqo
鷣	sjqo
䰤	sjrc
㯥	sjsj
檝	skby
頼	skdm
梋	skeg
㭭	skej
鶒	skeo
勅	sket
柺	sket
㩽	skfc
桯	skgg
杊	skh
㪃	skhc
㯝	skhk
樻	skhm
䱫	skjo
揧	skjr
樿	skkf
梠	skkg
梙	skkh
楍	skkk
槵	skkn
㮙	skkn
橾	skks
欕	skkt
㐓	sknb
賴	skqm
柷	skqn
鵣	skqo
遬	skqp
欶	skqw
㰤	skqw
㪼	skrh
戨	sksa
㢦	sksy
慗	sktn
鷘	skto
遫	sktp
辢	skuh
枴	skvt
喸	skxb
槶	slag
棝	sldg
栶	sldy
㭷	slet
盙	slf
㭗	slf
檡	slff
㯰	slfh
柶	slg
椳	slge
檈	slge
㮯	slge
檲	slgf
椢	slgy
㪝	slhc
檌	slhd
欙	slli
櫑	slll
楒	slny
梿	slpy
槤	slpy
㯮	slqj
鶫	slqo
㼑	slry
梱	slsy
棞	slty
樓	slvg
櫢	slvt
楐	slwj
榲	slwl
㮨	slwt
樏	slxi
欏	slxy
㰄	smaa
檂	smae
柵	smah
欁	smas
椣	smaw
椯	smdj
柍	smdy
榾	smeg
枏	smfg
柟	smfg
椆	smfk
梬	smgn
榿	smgu
杣	smh
櫻	smmv
楇	smnk
檛	smnp
㭎	smry
棗	smsm
僰	smsw
敇	smty
賈	smu
棡	smum
棢	smun
朿	smv
欈	smwk
梣	smwn
㰎	smwn
梤	smwv
槯	smwy
梖	smy
枬	smyg
榐	snae
乶	snb
朰	snb
㐉	snb
樼	snbb
㭾	snbm
梶	snen
㭄	snfh
㭒	sng
梛	sngb
楃	sngf
㮓	sngg
柌	sngk
椵	snhc
楈	snhe
杻	snhg
橻	snhg
朻	snhh
欘	snij
蚻	snju
椲	snkg
檘	snku
梮	snnk
㰑	snns
㯢	snnw
梞	snny
槢	snrg
榓	sntl
柲	sntt
榌	snuh
樛	snwe
櫂	snwy
㭈	snwy
紮	snxi
柅	snxn
杺	sny
樜	soao
櫎	soaw
㯶	sobt
櫥	soff
㔄	sojh
櫦	sont
橯	sooe
檆	sook
櫿	sook
橩	soow
棪	sooy
橉	soqg
㭽	soqy
㯅	sorf
榳	sotp
䙳	sou
欉	souc
檏	souf
樸	soug
䊲	soug
槦	sovh
槺	sovi
榶	sovk
椩	sovw
櫠	sowc
椨	sowf
樚	soxx
廼	spd
迺	spd
槣	spdk
㮫	spdk
櫶	spdn
椬	speg
䙶	spey
梡	spfq
榢	spge
榁	spgf
椗	spgh
檳	spgm
榠	spju
楎	splh
橣	spne
櫁	spnj
樒	spnm
㯽	spnm
檸	spns
椀	spqb
㭦	spta
楁	sptk
㰂	sptl
榟	spuh
椌	spwa
樎	spwj
棎	spws
柼	spwy
榊	spyh
棔	sqaj
桰	sqak
枊	sqbh
栁	sqbh
桞	sqbh
㮲	sqbt
栬	sqcn
橪	sqdo
檞	sqeg
㭤	sqgg
桝	sqgh
榤	sqgs
栒	sqjg
梚	sqkq
欃	sqky
㭸	sqky
㭵	sqlg
槝	sqmh
㭥	sqmy
枹	sqnn
櫓	sqoj
櫯	sqot
椈	sqoy
樢	sqoy
鵏	sqoy
㮧	sqoy
栘	sqqy
楤	sqrn
梑	sqto
枃	squg
棦	sqvh
檭	sqvy
杴	sqwy
橮	sqym
杦	sqyy
梍	sran
椶	srbt
柧	srcy
㮁	srde
桸	srdh
㭛	srey
楯	srfh
梔	srgc
楻	srgg
栃	srgq
杽	srh
榹	srhw
枛	srhy
槹	srif
檪	sris
楾	sriy
晳	srjf
蜤	srju
㰃	srmi
惁	srnu
櫆	srqf
礬	srrd
鬰	srre
䙪	srre
欎	srrf
欝	srrf
蠜	srrj
櫍	srrm
䫶	srrm
燓	srro
鐢	srrq
棥	srrs
榝	srsc
樧	srsc
椞	srsu
椑	srtf
橷	sruq
梹	srwy
梎	srxn
槪	srxq
櫟	srxs
覈	sryt
樷	ssbc
辳	ssde
䫐	ssdm
櫏	ssdp
埜	ssff
㯹	ssff
㮒	ssfg
標	ssfi
㮏	ssfi
檦	ssfj
䫴	ssfm
㱈	ssfw
榑	ssfy
梄	ssgg
梺	ssgh
槱	ssgo
朾	ssh
㪔	sshc
棟	ssjg
橝	ssjh
梀	sskg
䠂	sskh
楋	sskj
櫴	sskm
㯈	sskp
樕	sskw
榃	sslf
㰈	sslp
栜	ssmn
槚	ssmy
檟	ssmy
㷊	ssou
樮	ssoy
㯨	ssoy
䢞	sspi
椘	sspu
棾	sspw
鷅	ssqo
㯄	ssrc
檚	sssh
㯲	sssi
㭝	ssvb
楆	ssvg
㯟	ssvi
㯬	ssvp
㯃	sswi
檒	sswj
棽	sswn
棶	ssww
㭪	ssy
枡	stah
杔	stan
柂	stbn
桻	stdh
椥	stdk
橋	stdk
槰	stdp
檱	stdw
枖	stdy
㭚	stey
鬱	stfe
㮑	stfe
杄	stfh
櫡	stfj
欑	stfm
㭠	stfq
㮔	stgf
栍	stgg
栙	stgh
㭌	stgh
㯯	stgm
橅	stgo
櫄	stgo
柣	stgy
権	stgy
橰	sthf
㭊	sthn
㮩	sthn
梴	sthp
櫋	sthy
椼	stis
楿	stjg
梸	stjh
椱	stjt
楀	stky
桖	stlg
樬	stln
㭡	stlr
㮰	stlx
栴	stmy
桘	stng
杚	stnn
柹	stnt
橎	stol
覂	stpu
柉	stpy
㰀	stqi
橁	stqj
䅇	stu
㮽	stuc
㭔	stuf
櫤	stuj
柊	stuy
櫛	stvb
棅	stvg
㮃	stvg
樅	stwh
㯚	stwk
櫷	stxg
柇	sty
樦	styg
㰏	styk
杁	styy
栟	suah
㮶	sube
㮸	sudp
栚	sudy
櫳	sued
橌	sueg
椾	suej
檖	suep
梉	sufg
枓	sufh
柆	sug
椚	sug
棬	sugb
椦	suge
橍	sugg
柈	sugh
様	sugi
樣	sugi
榚	sugo
檨	sugw
檥	sugy
㰕	sugy
栤	suiy
椫	sujf
橦	sujf
橺	sujg
槞	sujn
檍	sujn
樈	sujq
棓	sukg
㭣	sukg
櫚	sukk
棁	sukq
橧	sulj
椪	suog
櫩	suqe
㯍	suqf
㮞	suqk
栨	suqw
橂	susd
楢	susg
欄	susl
櫬	susq
㯗	susy
槉	sutd
楌	sute
㯆	sutg
櫊	sutk
檤	sutp
橏	suuk
椄	suvg
槏	suvw
榏	suwl
樳	svaf
櫭	svag
楖	svbh
枠	svfh
橚	svfj
桪	svfy
㭮	svgq
㯸	svhl
椂	sviy
樔	svjs
柖	svkg
椔	svlg
㯿	svln
朹	svn
梫	svpc
䳩	svqo
覅	svqr
桚	svqy
朷	svt
桾	svtk
榋	svvv
梕	svyn
杒	svyy
栰	sway
㭖	sway
棇	swcn
㮬	swcn
枩	swcu
杸	swcy
覄	swdu
栿	swdy
柎	swfy
棆	swga
椧	swgb
楡	swgb
楑	swgd
㮉	swgd
檜	swgj
㭘	swgk
枍	swgn
㯓	swgn
楩	swgr
梌	swgs
検	swgw
檢	swgw
櫈	swgw
樇	swhe
樤	swhs
厀	swib
䣛	swib
㓼	swij
㯡	swin
桼	swiu
柗	swkg
梲	swkq
椺	swks
㮢	swnd
㯷	swog
栣	swtf
楓	swtj
㮆	swuh
椕	swvs
枌	swvt
麯	swwa
䴰	swwa
䴵	swwa
䴼	swwa
䴾	swwa
郲	swwb
麬	swwb
㮝	swwb
䴸	swwb
麮	swwc
麶	swwc
猌	swwd
䵂	swwd
勑	swwe
䴿	swwe
䵆	swwe
桽	swwf
麵	swwf
㙬	swwf
㭫	swwf
䴽	swwf
䵁	swwf
櫼	swwg
麩	swwg
麰	swwg
䴶	swwh
來	swwi
㭲	swwk
䴴	swwk
䴺	swwk
賚	swwm
顂	swwm
䴮	swwm
䵀	swwm
愸	swwn
憖	swwn
憗	swwn
麧	swwn
麪	swwn
麫	swwn
麭	swwn
鶆	swwo
䳵	swwo
逨	swwp
麥	swwq
麲	swwq
䚅	swwq
䴷	swwq
䴯	swwr
麱	swws
䴲	swws
䴹	swws
麨	swwt
䴭	swwt
麷	swwu
䵄	swwu
麳	swww
㯤	swww
䴳	swww
䵃	swww
䴱	swwx
䴬	swwy
橃	swxc
梻	swxj
杹	swxn
朲	swy
朳	swy
槜	swyb
欆	swyc
㮅	swyf
梒	swyk
槍	swyk
枔	swyn
棯	swyn
檇	swyn
杋	swyy
㯑	sxde
欚	sxej
柪	sxet
槇	sxhw
栺	sxjg
柫	sxjh
㯞	sxke
樌	sxmy
朼	sxn
杛	sxn
㰘	sxoa
檰	sxrh
榒	sxuu
櫞	sxxe
梐	sxxf
檵	sxxn
機	sxxw
栂	sxy
㭃	sxy
㭹	sxyx
槨	sybb
梈	sybh
橔	sybt
棛	syce
橀	sycl
㯙	syct
堏	syff
櫧	syfj
櫅	syjg
欀	syke
櫰	syle
檁	sylt
楄	syna
槴	sync
棙	synd
栐	syni
杧	synn
㮼	synn
枦	synt
怸	synu
椖	syny
㰔	syoc
檺	sype
鶐	sypo
楟	syps
橠	syqe
旉	syr
樆	syrc
㰚	syry
㯎	sysy
椸	sytb
栦	syth
㯀	syth
檹	sytk
懯	sytn
㮵	syty
樀	syud
楴	syuh
樴	syuj
㰅	syup
樃	syve
桹	syvy
椊	sywf
棜	sywu
棭	sywy
㯠	syxg
槒	syxl
箋	taau
㣤	taay
穁	tabg
笻	tabj
㣝	tadt
䄾	tadt
篋	tadw
䉈	taet
笁	taf
簕	tafe
䅿	tagg
筺	tagy
䇫	tahh
籃	tahl
䉯	tahm
熈	taho
㷩	taho
笌	taht
䄰	taht
徣	tajg
稓	tajg
稢	takg
䈅	takg
䈽	takg
籄	takm
稶	takr
䅦	talg
筪	talj
篢	tamu
穔	tamw
㣴	tamw
笹	tanb
秬	tang
衐	tans
䈎	tans
徔	tapy
䅾	taqj
䇝	tau
䅸	tauh
穫	tawc
籆	tawc
簭	tawk
遾	tawp
篫	tawr
築	taws
衖	taws
䅷	taws
䅒	tayn
䄩	tayy
竾	tbb
㐌	tbb
箃	tbcu
頺	tbdm
䇯	tbf
䉄	tbft
秄	tbg
䄦	tbh
䈄	tbib
䇰	tbig
篜	tbio
笜	tbmj
彵	tbn
䄬	tbn
箛	tbry
䄧	tbt
䉌	tbue
䈨	tbvu
䉁	tbwc
篨	tbws
秛	tby
彶	tbyy
笲	tcaj
穇	tcce
篸	tcce
䅟	tcde
䉊	tcdl
筩	tcej
秮	tckg
䈚	tckn
䈢	tcks
篤	tcou
稄	tcwt
矱	tdac
䑜	tdas
䢴	tdbh
䂐	tdbm
叐	tdci
秡	tdcy
頢	tddm
箶	tdef
䑚	tdeg
衚	tdes
㔚	tdet
䇢	tdf
䂔	tdff
䅶	tdff
圱	tdfg
䂒	tdfk
憇	tdfn
秙	tdg
䄷	tdg
䉞	tdgn
稧	tdhd
秠	tdhg
夆	tdhj
蠭	tdhj
䗬	tdhj
㶻	tdho
㷭	tdho
䂓	tdhq
篲	tdhv
䂑	tdhx
刋	tdjh
䅖	tdjn
舓	tdjr
聟	tdkb
敽	tdkc
勪	tdke
㲛	tdke
呑	tdkf
䣽	tdkg
喬	tdkk
䀉	tdkl
䝷	tdkm
䎗	tdkn
鷮	tdko
䢪	tdkp
䚐	tdkq
敿	tdkt
鼅	tdkx
䵹	tdkx
矲	tdlx
稬	tdmd
舑	tdmf
䑙	tdmf
䅡	tdmy
筬	tdnb
舏	tdnh
嵆	tdnm
㛷	tdnv
諬	tdny
舕	tdoo
鴁	tdqo
鴙	tdqo
鴰	tdqo
舚	tdqy
䑛	tdqy
徛	tdsk
矨	tdtd
舙	tdtd
矯	tdtk
矪	tdtu
簝	tdui
矰	tduj
䂏	tdvk
簊	tdwf
箺	tdwj
䉇	tdwj
谸	tdwk
簛	tdwr
筴	tdww
㣣	tdty
稘	tdwy
䂕	tdxe
㣕	tdy
㣖	tdyy
穩	tean
箙	tebc
筟	tebf
䈈	tecb
䅄	teee
䈱	teef
稝	teeg
䄴	teg
㣪	tegc
䈠	tegc
筯	tege
笡	tegf
穥	tegw
籅	tegw
稲	tehj
甪	tek
穱	telf
稱	temf
秏	ten
䉣	teqo
竻	ter
㣊	ter
簲	terf
䈻	tesu
䈧	teto
籐	teui
籘	teui
䅑	tevg
箏	tevh
穏	tevn
徯	texd
籖	tfag
䇳	tfau
㦵	tfay
缾	tfba
缷	tfbb
罎	tfbc
䍅	tfbc
罇	tfbf
䍂	tfbf
䍈	tfbf
䍋	tfba
缽	tfbg
罀	tfbi
罈	tfbj
㓡	tfbj
缿	tfbk
䍄	tfbk
䍌	tfbk
罏	tfbl
罁	tfbm
罆	tfbm
缹	tfbo
䍎	tfbo
䍇	tfbp
罉	tfbr
䍊	tfbr
䍆	tfbs
缼	tfbw
䍉	tfbw
缻	tfby
篕	tfcl
䅩	tfcw
秐	tfcy
秓	tfcy
⺧	tfd
穤	tfdj
敮	tfec
臿	tfed
㔓	tfet
玍	tff
䇞	tff
䉙	tffc
筀	tfff
篈	tfff
徍	tffg
䅅	tffg
徺	tffq
穘	tffq
秲	tffy
啎	tfgk
衎	tfgs
㼡	tfgy
徝	tfhg
稙	tfhg
憄	tfhn
衠	tfhs
䈯	tfhw
簳	tfjf
勂	tfke
籉	tfkf
㣟	tfkg
穯	tfkk
頶	tfkm
䎋	tfkn
鵠	tfko
䉹	tfkw
䧼	tfky
徳	tfln
㣮	tfmf
䈒	tfmf
籌	tfnf
忎	tfnu
䅴	tfpi
頲	tfpm
颋	tfpm
笎	tfqb
酂	tfqb
酇	tfqb
䢾	tfqb
劗	tfqj
㬱	tfqj
贊	tfqm
鴸	tfqo
兟	tfqq
衏	tfqs
㪇	tfqt
篏	tfqw
㰫	tfqw
簙	tfsf
筙	tfsu
䅲	tftj
䇭	tftx
㪓	tfuc
㔞	tfue
㣵	tfup
䉅	tfuy
稑	tfwf
穡	tfwk
䉢	tfwk
稜	tfwt
䈊	tfwt
籗	tfwy
籱	tfwy
鼄	tfxf
郵	tfab
㩾	tfac
䄯	tgah
剰	tajh
筭	tgaj
㣜	tgaj
䳠	tfao
乗	tad
甀	tfay
秷	tgcf
䇪	tgcf
犇	tgcg
箌	tgcj
幷	tgdf
筓	tgdf
逬	tgdp
甁	tgdy
篴	tgep
劮	tget
稏	tgfg
䄨	tgfh
彺	tgg
簮	tggj
䣃	tghb
䇥	tghf
徰	tghh
㔐	tghj
篶	tgho
䈣	tght
欫	tghw
夅	tgj
䄵	tgj
動	tgje
篿	tgjf
濌	tgjj
憅	tgjn
勲	tgjo
䳯	tgjo
稉	tgjr
㰱	tgjw
吿	tgkf
䈪	tgkh
稫	tgkl
䈏	tgkl
䇺	tgku
鄦	tglb
勳	tgle
無	tglo
鷡	tglo
橆	tgls
䄼	tglw
䇧	tglw
甒	tgly
製	tgme
穂	tgmn
䱥	tgmo
簀	tgmu
䇤	tgmw
穲	tgmx
籭	tgmx
積	tgmy
㣱	tgmy
怣	tgnu
䅉	tgog
䉔	tgqa
䅀	tgqj
鴩	tgqo
鵇	tgqo
䲼	tgqo
鸻	tgsg
鴴	tgso
甧	tgte
甡	tgtg
㚅	tgtg
㽓	tgtg
䇲	tgud
埀	tguf
徑	tgva
㔟	tgve
徢	tgvh
箑	tgvh
勧	tgwe
観	tgwq
穪	tgwr
籋	tgwr
歓	tgww
䇘	tgxf
䘘	tgxs
䄺	tgxw
䄮	tgy
㔍	thaj
郋	thbh
篹	thdb
鄓	thdb
簒	thdc
穢	thdh
䫁	thdm
䵵	thdo
籑	thdv
䉵	thdv
䇛	thf
䄳	thg
牋	thga
牑	thga
牐	thge
㲏	thge
㸢	thge
牔	thgf
㸡	thgf
㸣	thgf
牉	thgg
牗	thgh
㸠	thgi
牏	thgj
㸟	thgj
牊	thgk
牘	thgm
牎	thgn
牕	thgn
㸞	thgn
籧	thgp
覑	thgq
㸝	thgw
臰	thgx
牓	thgy
㸥	thgy
籰	thhc
徏	thht
忂	thhy
臯	thif
翺	thin
鷱	thio
篎	thit
䈇	thjj
笘	thkf
秥	thkg
㰶	thkw
齆	thlc
齅	thld
齈	thle
齉	thle
齇	thlg
䶊	thlg
鼼	thlh
䶑	thlh
齂	thli
䶐	thlj
齁	thlk
䶎	thlk
籚	thll
齃	thln
䶌	thln
鼿	thlq
齀	thly
䶋	thly
䈛	thmc
郔	thnb
鄎	thnb
蜑	thnj
䗺	thnj
臫	thnn
簴	thow
䫵	thpm
邉	thpp
邊	thpp
臱	thpy
筧	thqb
䅐	thqn
臲	thsb
㓷	thsj
鷍	thso
甈	thsy
㣠	thtu
辠	thuj
箎	thwb
臮	thwy
篊	tiaw
笵	tibb
筂	tibb
箥	tibu
箈	tick
䈌	tieg
箾	tiej
篞	tijf
䈋	tijf
簜	tijr
簹	tipl
䉎	tips
䇵	tirj
䈬	tisu
箵	tith
籓	titl
箲	titq
徶	tity
尓	tiu
筜	tivf
䈃	tivk
簗	tivs
馢	tjaa
篳	tjag
穝	tjbc
忁	tjbi
䭯	tjbm
䭰	tjdg
䭲	tjdk
䫝	tjdm
馣	tjdn
馛	tjdy
馟	tjeb
馞	tjfb
稈	tjfh
筸	tjfj
馩	tjfm
䅞	tjgf
徥	tjgh
䅠	tjgh
䈕	tjgh
馡	tjhd
䖝	tji
䭱	tjiy
䅛	tjjg
馧	tjjl
馤	tjjn
䖽	tjju
䅼	tjlc
䵩	tjlo
䈳	tjnf
馝	tjnt
䄿	tjnt
䇩	tjnt
悡	tjnu
馜	tjnx
馪	tjpm
鋫	tjqf
䅥	tjqn
䈓	tjqn
䱘	tjqo
䊬	tjso
篂	tjtg
馫	tjtj
馦	tjuw
㴝	tjwi
馠	tjwk
馚	tjwv
箟	tjxx
䅙	tjxx
箿	tkbf
㣬	tkbg
䇼	tkcb
頟	tkdm
䅌	tkeg
䇷	tkej
㕿	tkf
筽	tkgd
䇸	tkgf
徎	tkgg
簬	tkhk
簣	tkhm
䅪	tkhm
洜	tkiu
㓢	tkjh
筥	tkkf
簞	tkkf
䆆	tkks
䉷	tkkt
鄅	tkmb
㙑	tkmf
筼	tkmu
篔	tkmu
䎊	tkng
惒	tknu
㤩	tknu
鵅	tkqo
兎	tkqy
㪾	tkrh
敋	tkty
簂	tlag
簚	tlah
穓	tlaw
衊	tlaw
範	tlbb
衈	tlbg
卹	tlbh
䘏	tlbh
䘒	tlct
笝	tlcu
䆉	tlcx
甶	tld
箇	tldf
䉐	tldf
稒	tldg
衃	tldh
䅰	tldn
筃	tldu
秵	tldy
稩	tleg
盉	tlf
笽	tlf
䆁	tlff
䆀	tlfo
䡓	tlgs
衆	tliu
笚	tlj
䉪	tlll
簤	tlmu
䘔	tlpk
䉚	tlpy
䘓	tlqe
䰨	rqch
悤	tlqn
䰣	rqcr
䇱	tlqu
欰	tlqw
簐	tlqw
衇	tlre
㔡	tlre
顖	tlrm
䪿	tlrm
恖	tlrn
囪	tlry
稇	tlsy
簵	tltk
衉	tltk
箘	tltu
稛	tlty
簍	tlvf
䅹	tlvg
邍	tlvp
籔	tlvt
䘐	tlvw
衂	tlvy
䉖	tlwc
䉂	tlxi
籮	tlxy
䘑	tlyi
穠	tmae
筁	tmaf
躻	tmda
䠲	tmdc
躾	tmdd
䠶	tmdd
䡁	tmdd
躼	tmde
軂	tmde
軃	tmdf
軇	tmdf
䠵	tmdf
躰	tmdg
䡀	tmdg
躿	tmdi
䠷	tmdi
篅	tmdj
軄	tmdj
䠼	tmdj
躳	tmdk
躸	tmdk
軀	tmdk
䠺	tmdk
軉	tmdm
䠳	tmdm
䠿	tmdm
躵	tmdn
軈	tmdn
䠸	tmdn
躹	tmdo
鵢	tmdo
躭	tmdq
躱	tmds
躶	tmds
軆	tmdu
䇦	tmdu
䠴	tmdu
䠽	tmdu
躮	tmdv
躴	tmdv
躷	tmdv
躽	tmdv
軁	tmdv
䠹	tmdw
䠾	tmdw
䠻	tmdx
軅	tmdy
䅢	tmeg
䉰	tmer
簓	tmfe
徟	tmfk
秞	tmg
㣙	tmg
秱	tmgk
㣚	tmgk
㠞	tmgm
懲	tmgn
衕	tmgs
徴	tmgt
鰴	tmgt
黴	tmgt
㣲	tmgt
䅱	tmgu
秈	tmh
屲	tmj
㟀	tmj
䈟	tmjj
逈	tmkp
䚁	tmkq
笧	tmmg
䈀	tmmj
䈑	tmnk
簻	tmnp
嶴	tmom
䴈	tmoo
奧	tmtd
粵	tltn
䘗	tmts
幑	tmtt
筫	tmu
笍	tmwu
箆	tmwx
䄲	tmwy
徾	tmyt
笢	tnab
䦾	tncq
䅕	tndg
頧	tndm
䈐	tndo
戶	tne
䇻	tneb
䅏	tnen
䘀	tnfj
顊	tnfm
箼	tngf
師	tngh
徦	tnhc
䈔	tnhc
稰	tnhe
䈝	tnhe
篃	tnhf
䪠	tnhg
䪡	tnhg
䪢	tnhg
歸	tnhh
䙻	tnhq
㣯	tnie
徲	tnig
穉	tnig
䆈	tnip
刉	tnjh
蛗	tnju
徫	tnkg
稦	tnkg
躗	tnkh
躛	tnkh
㦣	tnkn
衛	tnks
衞	tnks
䘙	tnks
讆	tnky
讏	tnky
帥	tnmh
峊	tnmj
䄫	tnn
毎	tnnf
㷗	tnno
簨	tnnw
鴭	tnqo
簈	tntf
㩿	tnty
箳	tnua
稺	tnuh
穋	tnwe
籊	tnwy
秜	tnxn
笖	tnyw
䉀	toao
穬	toaw
䎹	tobf
䣋	tobh
㣸	toeg
甃	togy
釆	toi
湬	toiu
稥	tojf
蝵	toju
勫	tole
釋	tolf
飜	tolh
鷭	tolo
䆏	tolw
㽃	toly
㡑	tomh
釈	tony
簩	tooe
鍫	toqf
鹙	toqg
鶖	toqo
揫	torj
醔	tosg
䅊	tota
夈	tou
穙	toug
簾	touw
䆂	touw
媝	tovf
穅	tovi
篖	tovk
䅯	tovk
䉤	tovt
䉬	towc
㣹	town
䧽	towy
䨂	towy
䵸	toxf
穮	toxo
簺	tpaf
秾	tpey
徖	tpfi
筦	tpfq
簆	tpft
箮	tpgg
穦	tpgm
䈿	tpju
䈼	tpnm
㣷	tpns
鴔	tpqo
䇡	tpsj
筞	tpsu
秺	tpta
䉱	tpuk
䅝	tpwa
䈹	tpwj
穃	tpwk
䈶	tpwk
篧	tpwy
簶	tpyi
籛	tqaa
秖	tqan
彽	tqay
秪	tqay
禿	tqb
篘	tqbt
䅳	tqbt
頹	tqdm
簷	tqdy
䈥	tqee
䈸	tqef
䉏	tqeg
䇶	tqej
䇟	tqer
䚘	tqes
䉉	tqey
篯	tqga
穞	tqgj
銜	tqgs
筄	tqiu
䄻	tqiy
箰	tqjb
筍	tqjf
穐	tqjn
䅓	tqkc
㣘	tqkg
䅋	tqkq
笣	tqnb
穭	tqoj
鵆	tqos
穒	tqou
䉆	tqou
䉳	tqou
䈡	tqrn
笷	tqtb
籦	tqtf
犂	tqtg
睝	tqth
䖿	tqtj
㥎	tqtn
鯬	tqto
鵹	tqto
䊍	tqto
邌	tqtp
錅	tqtq
䴻	tqtq
䇖	tqtr
棃	tqts
剓	tqtv
笉	tquf
籙	tqvi
䇜	tqwu
䆋	tqxg
䉧	tqyj
彴	tqyy
䄪	tqyy
簼	traf
簎	traj
稯	trbt
㣭	trbt
䈦	trbt
笟	trcy
䄸	trg
䅣	trgg
籒	trgl
䈰	trie
䉗	trkb
箉	trke
籜	trlf
䖸	trnj
鵝	trno
鵞	trno
䈭	trqc
篺	trrf
䇽	trrj
笅	trru
箄	trtf
䉥	trtn
䉟	trwc
籡	trww
篐	tsah
䉩	tsak
䉦	tsdp
簯	tsdw
䇴	tsf
䈤	tsff
徱	tsfi
篻	tsfi
䅺	tsfi
籈	tsfy
徆	tsg
䄽	tsg
㣔	tsh
䈾	tsie
䉓	tsjs
笴	tskf
䇿	tskf
籟	tskm
簠	tslf
徚	tslg
箣	tsmj
䉘	tspi
籕	tsql
箖	tssu
㣩	tssy
䈷	tstk
徠	tsww
箂	tsww
䅘	tsww
秿	tsy
䢤	tsyp
術	tsys
秅	ttan
䅎	ttbt
筈	ttdf
秳	ttdg
穚	ttdk
簥	ttdk
笶	ttdu
秗	ttdy
䆌	ttdy
䉜	ttdy
䅤	ttfe
䄭	ttfh
秊	ttfj
筶	ttfk
穳	ttfm
籫	ttfm
㷏	ttfo
筳	ttfp
簉	ttfp
䅍	ttfp
䘖	ttfs
䇬	ttfu
秼	ttfy
𠂉	ttg
種	ttgf
箠	ttfa
箽	ttgf
㣫	ttgf
䅜	ttfa
徃	ttgg
禦	ttgi
䇨	ttgj
㣳	ttgo
䉑	ttgo
筕	ttgs
衘	ttgs
衝	ttgs
㘒	ttgx
⺮	ttgy
秨	tthf
簰	tthf
簁	tthh
籩	tthp
䅨	ttjg
筣	ttjj
復	ttjt
稪	ttjt
笿	ttkf
䅂	ttkg
䉛	ttmd
䉠	ttmt
篩	ttnh
䉒	ttol
㣰	tton
篍	ttou
䉫	ttqi
簃	ttqq
筿	ttsu
篽	tttb
籞	ttti
䈲	ttuc
䈖	ttuf
笗	ttuu
箻	ttvg
㣦	ttvg
䅗	ttvg
篵	ttwh
龝	ttxg
秝	tty
艧	tuac
穣	tuae
艜	tuah
䈂	tuaj
艦	tual
艓	tuas
舼	tuaw
郍	tubh
䑠	tubh
䑥	tuby
舥	tucn
䑡	tucy
䑩	tudg
㸔	tudh
舿	tudn
䑴	tudw
舦	tudy
乊	tue
艀	tueb
䉨	tuec
徿	tued
籠	tued
䆍	tued
穟	tuep
䑣	tuet
艢	tufk
䒈	tufm
乯	tufn
艝	tufv
箞	tugb
䅚	tugb
䑶	tuge
秚	tugh
䅵	tugo
䑢	tugq
䉝	tugy
艣	tuhe
䑰	tuhh
䑲	tuhj
艫	tuhl
䚀	tuhq
従	tuhy
䑭	tuia
艡	tuil
䑵	tuje
徸	tujf
穜	tujf
簡	tujf
艃	tujf
䅧	tujg
艒	tujh
篭	tujn
䑽	tujn
篰	tukb
箁	tukf
稖	tukg
艥	tuky
舺	tulh
䉕	tulj
艛	tulv
乥	tunb
㐑	tunb
艍	tund
䎇	tung
䒁	tunr
䉍	tunu
艔	tuoc
䑱	tupb
䑹	tupc
䑸	tupi
䑿	tupj
䒄	tupl
䒇	tupl
䉃	tuqf
鸼	tuqg
䑬	tuqi
艪	tuqj
䈮	tuqk
䑦	tuqk
䆅	tuqm
鵃	tuqo
鷑	tuqo
䳉	tuqo
䑼	tuqt
䅆	tuqw
艬	tuqy
艎	turg
艊	turh
艐	turt
筊	turu
籣	tusl
㭧	tusu
䑨	tutb
䒀	tutf
簅	tutg
舽	tutg
䒉	tutg
艂	tuth
艞	tuti
艁	tutk
䒃	tutp
衜	tuts
䶱	tutx
舧	tuty
艖	tuua
䑫	tuua
䒂	tuuf
䒅	tuuh
艗	tuul
䲍	tuuo
䑯	tuut
艤	tuuy
䈉	tuvf
舠	tuvt
稴	tuvw
䈴	tuvw
䑳	tuwa
舩	tuwc
舲	tuwc
艭	tuwc
䑾	tuwc
褩	tuwe
鞶	tuwf
䑧	tuwf
幋	tuwh
縏	tuwi
螌	tuwj
䑺	tuwj
艙	tuwk
䑪	tuwk
盤	tuwl
䅬	tuwl
艌	tuwn
䑤	tuwn
鎜	tuwq
搫	tuwr
槃	tuws
艅	tuws
䑮	tuws
艠	tuwu
媻	tuwv
舤	tuwy
䉮	tuwy
䧷	tuwy
稊	tuxt
㣢	tuxt
䆊	tuxw
稵	tuxx
䈘	tuxx
艑	tuya
䑻	tuyb
䑷	tuye
艩	tuyj
艈	tuyk
舮	tuyn
䒆	tuyt
簢	tuyu
䉸	tuyu
艆	tuyv
艕	tuyy
穊	tvaq
節	tvbj
蠞	tvbj
笯	tvcu
㣨	tvdg
䫋	tvdm
衟	tvds
簫	tvfj
筆	tvgj
徤	tvgp
瓾	tvgy
覣	tvhq
箓	tviu
筎	tvkf
䅔	tvlg
䉭	tvln
䉋	tvnh
簘	tvoj
箒	tvph
犩	tvrg
䭳	tvrj
䇹	tvtk
笂	tvyu
秇	tvyy
笩	tway
垼	twcf
䈵	twcn
㣞	twcq
䈗	twct
䇗	twcu
彸	twcy
頽	twdm
㣥	twff
穄	twfi
稐	twga
籥	twga
䈁	twga
篟	twge
劄	twgj
徻	twgj
箚	twgj
䈩	twgj
秴	twgk
㣛	twgk
籲	twgm
箯	twgr
稌	twgs
筡	twgs
籢	twgt
簽	twgw
籨	twgw
篠	twhs
䇚	twhu
黐	twic
䵕	twid
䵚	twie
䵜	twie
䵛	twif
䵓	twig
㓿	twij
䵒	twij
䵔	twij
䵗	twil
䵙	twiq
䵘	twir
䇣	twiu
䵑	twiy
筗	twkh
㣡	twkh
穨	twkm
稅	twkq
鵚	twqo
䆇	twqo
秹	twtf
筰	twtf
䄹	twtf
䇮	twtf
秂	twu
凢	twv
処	twv
䈜	twvc
籂	twvh
秎	twvt
聳	twwb
籤	twwg
㹐	twwg
䆎	twwg
從	twwh
慫	twwn
熧	twwo
䳷	twwo
䢨	twwp
㼻	twwy
彾	twyc
秢	twyc
笭	twyc
篗	twyc
䉶	twyc
筨	twyk
篬	twyk
䅮	twyk
笒	twyn
穛	twyo
穕	twys
衑	twys
竼	twyu
篒	twyv
龜	txd
㣧	txen
䶰	txen
勄	txet
䈙	txfu
䉲	txgr
䇙	txhj
彿	txjh
䄶	txjh
笰	txjj
䈫	txmw
箹	txqy
籎	txth
瀪	txti
緐	txti
慜	txtn
鰵	txto
䵈	txts
䈺	txtu
篛	txuu
䌓	txwi
笓	txxb
㶗	txxi
䋣	txxi
稭	txxr
籪	txxr
穖	txxw
㒰	tyaf
䓥	tyaj
稕	tybg
㒴	tybm
勶	tyce
徹	tyct
簱	tydw
籝	tyey
籯	tyey
䇾	tyf
簔	tyge
䇠	tygf
笇	tyhu
稤	tyiy
㒲	tyjf
穧	tyjg
䅫	tyji
忀	tyke
簑	tyke
䉴	tyke
䈞	tyjf
㣶	tylg
䆄	tylg
䉡	tylg
㠳	tymh
屳	tymj
肏	tymw
徧	tyna
稨	tyna
笀	tynb
㐈	tynb
簄	tync
䈆	tynd
䈍	tynh
㤀	tynn
㣗	tynt
兦	tynv
糴	tyoy
䨀	tyoy
籇	type
込	typi
鳰	tyqo
㒱	tyqu
䅻	tyrc
籬	tyry
䄱	tyt
箷	tytb
籏	tytw
徬	tyuy
篣	tyuy
䅭	tyuy
筤	tyvu
笐	tywb
稡	tywf
箤	tywf
秔	tywn
䘕	tyws
箊	tywu
稸	tyxl
衒	tyxs
郱	uabh
㿷	uaby
疘	uad
瘔	uadd
頩	uadm
羢	uadt
㔙	uaet
㐮	uaeu
冮	uag
齹	uahb
冴	uaht
疨	uaht
閕	uaht
竎	uaj
瘄	uajd
䇎	uajg
癘	uajy
瘽	uakg
閾	uakg
癱	uaky
䡨	ualj
䦫	uamd
牃	uans
㤣	uanu
疶	uanv
㷢	uaou
艵	uaqc
㿃	uaqh
㿊	uaqj
䍼	uaqj
鵧	uaqo
㭍	uasu
㿄	uatc
剙	uavw
剏	uavy
閧	uawi
闀	uawn
㓒	uawn
㓋	uawy
䇅	uay
聞	ubd
疓	ube
癮	uben
兯	ubj
㽾	ubmk
痾	ubsk
愬	ubtn
遡	ubtp
屰	ubtr
欮	ubtw
癊	ubwc
㾻	ubws
閞	ucak
慿	ucan
䍳	uccc
䦤	uccc
瘮	ucce
瘆	ucde
䇈	ucfg
㾂	uckd
羓	ucn
闖	ucoi
㵗	ucoi
㾺	ucoi
憑	ucon
凴	ucow
馮	ucoy
竢	uctd
痠	ucwt
閎	udci
冹	udcy
竑	udcy
閆	udd
㽽	udd
䦒	udd
痏	uded
㾰	uded
痮	udei
㓈	udg
䇉	udg
羬	udgk
㓕	udgo
瘈	udhd
䦬	udhd
㓗	udhi
竰	udjf
竡	udjg
痷	udjn
閹	udjn
㾍	udmj
痝	udny
羱	udri
㾨	udsk
癧	udth
䍽	udth
療	udui
瘞	udwf
㿓	udwh
䦮	udwj
瘎	udwn
瘱	udwn
凘	udwr
㾜	udww
狀	udy
㽴	udyi
閒	ued
閰	ued
顡	uedm
痭	ueed
奨	uefd
醤	uefg
龏	uega
聾	uegb
礱	uegd
龍	uegd
龑	uegd
龖	uegd
龘	uegd
襲	uege
壟	uegf
龒	uegi
蠪	uegj
驡	uego
鸗	uego
㰍	uegs
龔	uegw
讋	uegy
覵	uehq
㮍	uejs
竓	uen
㲔	uen
癙	uenn
閿	uepc
㸂	uepo
䍲	ueqn
鷳	ueqo
䦧	ueqv
劷	uet
羏	uet
䦱	ueto
豙	ueu
㒸	ueu
辦	ueuh
閐	uev
凈	uevh
弉	ufaj
羵	ufam
㿎	ufam
㾡	ufcb
㽻	ufci
㾀	ufci
闔	ufcl
攱	ufcy
㽵	ufd
䦌	ufd
羺	ufdj
䇕	ufdj
閨	uffd
㾏	uffd
䦙	uffi
壯	ufg
竍	ufh
癲	ufhm
㿐	ufhq
瘨	ufhw
闐	ufhw
疛	ufi
閈	ufk
闬	ufk
䦖	ufkd
㪳	ufkf
闧	ufkp
㖍	ufkx
癗	ufld
凟	uflm
㓓	ufmf
乧	ufnb
㪲	ufnb
㿒	ufnf
疞	ufnv
䦝	ufoi
焋	ufou
䢏	ufpk
銺	ufqf
痲	ufqq
䦎	ufqv
痚	uftb
閉	ufte
瘏	uftj
闍	uftj
阇	uftj
㓑	ufuf
闥	ufup
娤	ufvf
㓐	ufwf
牆	ufwk
癨	ufwy
裝	ufye
開	ugak
勌	ugbe
痓	ugcf
駦	ugco
䦯	ugct
閂	ugd
閏	ugd
頖	ugdm
凊	ugeg
劵	uger
䦠	ugey
⺷	ugf
瘂	ugfg
閸	ugfg
䄅	ugfi
㽳	ugfk
癋	ugfn
齤	ughb
疜	ughi
閇	ughi
闚	ughq
龹	ugi
羨	ugiw
竱	ugjf
奍	ugjj
癅	ugjl
鵥	ugjo
㾘	ugjr
䖭	ugju
䦜	ugkd
闘	ugkf
竵	ugkh
帣	ugmh
䍨	ugmh
㿛	ugmx
巻	ugnb
韏	ugng
㽲	ugnv
羮	ugog
䫞	ugom
羙	ugou
㕗	ugqc
觠	ugqe
㾐	ugqj
鮝	ugqo
鯗	ugqo
㾲	ugqt
羑	ugqy
䍪	ugsy
䣡	ugtb
牶	ugtg
䴊	ugto
䅈	ugtu
義	ugty
閛	uguf
㪵	uguf
䍬	uguf
䢭	ugup
痙	ugva
羥	ugva
㓬	ugvj
㔦	ugye
䦵	ugwr
餋	ugwv
弮	ugxb
勬	ugxe
絭	ugxi
羛	ugxj
羠	ugxw
㿀	ugyg
羕	ugyi
閠	ugyi
飬	ugyv
養	ugyv
瘧	uhag
㾇	uhd
闃	uhdi
闅	uhhc
㾟	uhhe
㾥	uhic
竨	uhjh
䇂	uhk
痁	uhkd
䦓	uhkd
㿖	uhll
門	uhng
㾎	uhng
䦩	uhti
㾚	uhxf
㾹	uhxs
痟	uied
䇌	uieg
䦢	uifc
䦞	uigd
閖	uii
㽷	uii
閯	uiit
闛	uipf
闣	uipl
闊	uitd
㾪	uith
竗	uitt
㵷	uiuh
頀	ujac
韺	ujad
㓖	ujag
䪦	ujag
贑	ujam
戅	ujan
韷	ujbm
䪧	ujbn
間	ujd
䪬	ujfb
㾖	ujfd
勭	ujfe
氃	ujfe
䴀	ujfo
䚒	ujfq
㼿	ujfy
䪫	ujga
䦔	ujgd
韴	ujgh
瘍	ujgr
痩	ujhc
覸	ujhq
痋	uji
閩	uji
閶	ujjd
韻	ujkm
竜	ujnb
闒	ujnd
阘	ujnd
鷾	ujno
遧	ujpk
䦪	ujqn
鶕	ujqo
鷼	ujqo
竸	ujqq
痬	ujqr
䪮	ujqt
嬜	ujqv
䪨	ujqy
韹	ujrg
㾧	ujsi
䤗	ujtg
韸	ujth
䀍	ujtl
贛	ujtm
戇	ujtn
韼	ujtp
竷	ujtt
䪭	ujuj
䪰	ujun
䪩	ujwn
閺	ujyi
問	ukd
䫓	ukdm
㾓	uked
勏	uket
袞	ukeu
咅	ukf
㖖	ukf
㪗	ukhc
竒	ukhj
闠	ukhm
阓	ukhm
㿉	ukhm
䇍	ukhy
郶	ukkc
閭	ukkd
㾔	ukkd
癉	ukkf
闡	ukkf
闆	ukkk
䍺	ukkn
㿋	ukks
兗	ukqb
䬇	ukqj
䫄	ukqm
䳝	ukqo
競	ukqq
敚	ukqt
㰴	ukqw
敨	ukty
疻	ukwi
兾	ulaw
凅	uldg
䍰	uldy
凙	ulff
癦	ulff
䦴	ulff
癏	ulge
闤	ulge
阛	ulge
㾯	ulge
瘝	ulii
鄫	uljb
䒏	uljc
㣒	ulje
曽	uljf
䎖	uljn
朆	uljr
閘	ulk
閳	ulk
㾝	ulk
痐	ulkd
㿙	ulld
癳	ulli
㿔	ulll
閫	ulsi
瘻	ulvd
㿚	ulxy
癑	umae
闦	umau
痶	umaw
㾄	umd
㾶	umed
㾆	umfd
痌	umgk
㓊	umgk
㿂	umgt
凒	umgu
闓	umgu
䦸	ujmy
閴	umi
閊	umk
癭	ummv
瘑	umnk
闿	umnv
闝	umti
㓏	umwk
凗	umwy
冺	unan
䇇	unan
闞	unbt
羗	unci
瘺	unfi
㽱	unhk
悶	uni
闈	unkg
䍷	unkg
闢	unku
乵	unn
䇃	unn
䍻	unnw
㿇	unrd
閟	unte
竮	unua
㦚	unuh
㽶	unv
疦	unwi
䦑	unwi
㿑	unwy
痆	unxv
䇊	uocy
並	uof
焛	uoi
疢	uoi
㠮	uoja
羻	uont
癆	uooe
㿘	uook
㸉	uooo
牅	uovh
竤	updc
竩	upeg
羦	upfq
凕	upju
瘒	uplk
痯	upnd
䦡	upnd
㽸	upqv
竚	upsh
羜	upsh
羫	upwa
㸜	upwa
㾤	upwa
䍫	upxn
㾃	upxv
痻	uqaj
閽	uqaj
疧	uqav
疷	uqay
㾣	uqd
䦦	uqd
䍯	uqdb
癚	uqdy
䦲	uqdy
閻	uqed
㿍	uqeg
㢡	uqfa
奬	uqfd
獎	uqfd
墏	uqff
醬	uqfg
漿	uqfi
螀	uqfj
螿	uqfj
䵼	uqfn
䊢	uqfo
槳	uqfs
將	uqfy
凎	uqg
鲝	uqgf
䍮	uqiy
䦰	uqjn
痀	uqkd
竘	uqkg
凂	uqkq
瘓	uqmd
癬	uqou
鮺	uqou
鴗	uqoy
鴹	uqoy
痑	uqqi
瘹	uqqy
䇋	uqqy
㾠	uqtg
竫	uqvh
䦛	uqvh
䦶	uqvh
䍵	uqvh
垐	uqwf
資	uqwm
乲	uqwn
䳐	uqwo
栥	uqws
楶	uqws
秶	uqwt
餈	uqwv
㿰	urby
㽹	urci
㽿	urcy
㿁	urdf
㾙	urdh
頝	urdm
効	uret
㾮	urgd
斨	urh
虠	urhw
㾷	urhw
闎	urii
䦐	urk
䢒	urpi
瘣	urqc
䴔	urqg
鵁	urqo
痺	urtf
䇑	urtf
兿	urvc
閪	usd
闉	usfd
凐	usfg
䍸	usfy
鄭	usgb
㾞	usgd
䤋	usgg
蠤	usgj
鷷	usgo
㷕	usgo
㽀	usgy
㓅	ush
親	ushq
痡	usi
閑	usi
䦨	usjd
凍	usjg
㾴	useg
䍶	usjg
閅	usk
閜	uskd
凁	uskg
牁	uskg
癩	uskm
瘷	uskt
瘶	uskw
闌	usld
㾊	usmv
鷴	usqo
㜪	usrv
凚	ussi
痳	ussi
䦥	ussi
凓	ussy
闄	usvd
㾢	usww
牀	usy
㾁	usyi
竔	utah
凞	utao
痵	utbd
䦚	utdd
㓉	utdg
㓇	utdy
閁	ute
顔	utem
遃	utep
竏	utfh
閮	utfp
㾌	utfq
㾩	utfx
瘇	utgf
痸	utgj
癪	utgm
癟	utha
㿜	utha
䍹	uthd
導	uthf
㿅	uthh
噵	uthk
䭭	uthm
瘜	uthn
闑	uths
䆃	utht
㸤	uthu
㘏	uthx
䦭	utjd
閣	utkd
竬	utky
䦗	utld
㓔	utmf
癓	utmt
癥	utmt
竧	utmt
㽺	ubyi
䇄	utnn
㾽	utnp
㾅	utnt
䦍	utnv
㾭	utoi
羳	utol
疺	utpi
産	uttg
剷	uttj
癁	uttt
癤	utvb
䍴	utvg
亷	utvw
瘲	utwh
㿗	utwm
痜	utwv
痗	utxi
䍩	uty
㿆	utye
䦕	uuak
瘚	uubw
闕	uubw
閚	uud
闁	uud
関	uudi
癇	uued
䇆	uufh
閗	uufk
竝	uug
闂	uugb
冸	uugh
癢	uugv
牂	uuh
辡	uuh
瘖	uujd
癎	uujd
闇	uujd
暜	uujf
㾕	uuk
㪨	uukc
㾦	uukd
䦣	uukd
痥	uukq
閲	uukq
敾	uukt
歚	uukw
竲	uulj
㿕	uuqe
㾳	uuqv
竴	uusf
羴	uuuj
㾾	uuvw
疩	uvfk
妝	uvg
冿	uvgh
䦘	uvi
䇐	uviy
㪠	uvjc
䫡	uvjm
鶼	uvjo
㝺	uvjt
甉	uvjy
㾒	uvkd
㸛	uvkg
癰	uvky
㓎	uvpc
㾛	uvpc
㾼	uvpi
㿏	uvtu
辧	uvuh
閥	uwai
竐	uwcy
羖	uwcy
㾈	uwfi
㾱	uwfq
闋	uwgd
㓌	uwgg
瘉	uwgj
癐	uwgj
羭	uwgj
冾	uwgk
閤	uwgk
㾑	uwgk
癒	uwgn
闟	uwgn
凃	uwgs
䍱	uwgs
竳	uwgu
羷	uwgw
㿌	uwgw
閃	uwi
䦏	uwjk
䘱	uwke
閱	uwkq
鹢	uwlg
鷁	uwlo
䚊	uwlq
竌	uwn
㾋	uwsi
瘋	uwtj
闏	uwtj
颯	uwtj
竕	uwvt
羒	uwvt
䦟	uwwf
䦷	uwwf
疭	uwwi
閦	uwww
癈	uwxc
㓆	uwxn
閄	uwy
竛	uwyc
閝	uwyc
㕠	uwyc
㾉	uwyc
痽	uwyd
閵	uwyd
凖	uwyf
凔	uwyk
牄	uwyk
瘡	uwyk
癄	uwyo
飡	uwyv
瘬	uxde
鄁	uxeb
㘳	uxff
丠	uxgf
弚	uxhj
䶏	uxhj
㽼	uxhk
鵜	uxho
辮	uxiu
疿	uxjk
軰	uxlj
䉾	uxou
㼱	uxpy
䦳	uxtb
癡	uxth
㿈	uxty
疕	uxv
關	uxxg
闗	uxxo
鶿	uxxo
鷀	uxxo
㾬	uxxr
疪	uxxv
甆	uxxy
䍭	uxy
凉	uy
䇏	uybg
㓍	uycq
訚	uyd
誾	uyd
閍	uye
㾵	uyfk
閔	uyi
凉	uyiy
凉	uyiy
癠	uyjd
羶	uylg
癝	uyli
凜	uylt
癛	uylt
閙	uymh
㾸	uymk
㾫	uyna
闙	uynt
痎	uynw
閡	uynw
丷	uyt
瘯	uytd
䒑	uytg
⺶	uytt
辬	uyuh
辯	uyuh
㾿	uyvb
閬	uyvi
㾗	uyvi
羪	uyvy
閼	uywu
閌	uywv
癴	uyxr
癵	uyxw
癕	uyxy
譱	uyyd
嫟	vaak
嬺	vaan
媶	vabg
婼	vadk
娀	vadt
妅	vag
嬅	vagg
姫	vahh
㜮	vahl
㜯	vaho
㛭	vajg
鄩	vakb
彠	vakc
尋	vakf
嫤	vakg
嫨	vakg
嫗	vakk
䫮	vakm
嬿	vako
孉	vaky
媌	valg
媖	vamd
嫹	vamw
姖	vang
媟	vans
䐴	vaqe
塈	vaqf
䀈	vaql
鱀	vaqo
䊠	vaqo
㮣	vaqs
䇒	vaqu
嬞	vatf
嫕	vatn
孏	vaul
㝷	vavf
嬳	vawc
㜓	vawk
婲	vawx
娂	vawy
㚤	vayy
㚺	vbbg
娵	vbcy
嫷	vbde
㜽	vbf
堲	vbff
㛅	vbg
邚	vbh
恏	vbnu
䳭	vbqo
㛆	vbsy
㚫	vbyy
娺	vccc
㜗	vcce
㜼	vllg
駑	vcco
砮	vcdf
姢	vceg
㛚	vceh
㗠	vckx
妑	vcn
㐐	vcnb
媃	vcns
媽	vcoy
鴑	vcqo
拏	vcrj
娭	vctd
㛌	vctg
厹	vcu
㛖	vcwt
䋈	vcxi
媠	vdae
妭	vdcy
姷	vdeg
媩	vdeg
娾	vdff
媷	vdff
㛻	vdff
姱	vdfn
妬	vdg
㛾	vdgk
媙	vdgv
㚰	vdhg
妦	vdhh
娝	vdhk
妚	vdhy
㛪	vdjn
媔	vdlf
媆	vdmd
㐡	vdmd
㚴	vdmh
䎟	vdmj
頄	vdmy
㛲	vdmy
䫀	vdmy
娍	vdnn
娏	vdny
㚭	vdny
娔	vdqn
嫄	vdri
婍	vdsk
㚑	vdu
嫴	vduh
嫽	vdui
㜧	vduw
媋	vdwj
媅	vdwn
嫀	vdwt
㛍	vdww
娸	vdwy
㜒	veah
娐	vebg
嫍	veeg
嬩	vegw
㚳	vekg
㛵	vemf
嬹	vemw
㚪	ven
嬡	vept
婗	veqn
婇	vesy
媱	vetb
婬	vetf
嬀	veto
娞	vevg
㜎	vexd
彟	vfac
妘	vfcy
嬬	vfdj
嫮	vffn
㜇	vffn
㥨	vffn
嬈	vffq
姏	vfg
嫃	vfhw
㐤	vfhw
卆	vfj
㪩	vfjc
書	vfjf
晝	vfjg
妌	vfjh
㔅	vfjj
肅	vfjk
䎘	vfjn
鷫	vfjo
歗	vfjw
媴	vfke
嬯	vfkf
姞	vfkg
㛸	vfku
畵	vflb
畫	vflg
劃	vflj
嬻	vflm
婻	vfmf
嬦	vfnf
娡	vfny
㛘	vfpb
嬄	vfpu
妧	vfqn
媎	vftj
㛈	vftn
婞	vfuf
㛬	vfwf
嬙	vfwk
婈	vfwt
㛞	vgah
娬	vgay
姪	vgcf
姸	vgdf
衋	vgdl
䀌	vgdl
婖	vgdn
婭	vgfg
㚥	vgfh
姃	vghg
㛏	vgiy
嫥	vgjf
姮	vgjg
㚦	vgjh
㛐	vgjr
娪	vgkg
㛿	vgkh
㛒	vgku
婳	vglb
姉	vgmh
㜴	valh
㜖	vgmj
孋	vgmx
嫧	vgmy
㛤	vgmy
㶳	vfou
䢖	vgpk
㜜	vgqt
妺	vgsy
㛁	vguf
娙	vgva
嬭	vgwr
嫊	vgxi
妋	vgy
婔	vhdd
㜘	vheg
⺻	vhgd
盡	vhgl
䀆	vhgl
賮	vhgm
㜹	vhhy
婌	vhic
鹔	vhjg
婥	vhjh
㚲	vhkg
媜	vhmy
娊	vhqn
嫭	vhtf
媫	vhvh
婋	vhwn
虓	vhwn
䏋	vhwn
娋	vieg
姯	vigq
㪖	vihc
䚄	vihq
㛥	vijg
盝	vilf
㜭	vipl
媣	vivs
娨	vjfh
婣	vjgg
媞	vjgh
婸	vjgr
媢	vjhg
妽	vjhh
嫚	vjlc
媀	vjmy
㛫	vjqr
鄛	vjsb
勦	vjse
婐	vjsy
婫	vjxx
卲	vkbh
綤	vkbi
㛕	vkcn
雝	vkcy
叴	vkf
妕	vkhh
嬇	vkhm
䙼	vkhq
娖	vkhy
刟	vkjh
嬋	vkkf
㛎	vkkg
嬠	vkks
孍	vkkt
㖲	vkkx
帤	vkmh
㛣	vkmy
㜏	vkmy
㐒	vknb
娛	vknd
䎄	vkng
巶	vknn
娯	vknw
㚾	vkqn
鴽	vkqo
䳂	vkqo
欩	vkqw
挐	vkrj
桇	vksu
䘫	vkye
䣎	vlbh
婟	vldg
媦	vleg
娚	vlet
嫐	vlev
嬕	vlff
嫼	vlfo
㚼	vlg
嬛	vlge
㛱	vlge
疀	vlgh
嬽	vlhd
㓯	vljh
㜥	vlmy
媤	vlny
㜕	vlpy
鶅	vlqo
㜛	vlqw
巤	vlrn
㜢	vlvg
媼	vlwl
姍	vmah
婰	vmaw
婩	vmdf
㛧	vmdg
媏	vmdj
㛶	vmdo
姎	vmdy
姌	vmfg
㚩	vmfg
婤	vmfk
姛	vmgk
媺	vmgt
嬍	vmgt
㜐	vmgu
奾	vmh
帇	vmhk
㞪	vmj
孆	vmmv
媧	vmnk
孈	vmwk
妠	vmwy
㜠	vmwy
㛝	vmy
㜊	vnae
㛰	vnaj
姄	vnan
㐇	vnb
㜟	vnbt
婮	vndg
㚨	vnfh
㚶	vng
媉	vngf
㚸	vngk
婽	vnhc
㜨	vnig
孎	vnij
媁	vnkg
妼	vntt
㣽	vnu
嫪	vnwe
妜	vnwy
嬥	vnwy
嫬	voao
㛇	vofg
粛	vojk
嬫	voos
婒	vooy
㜆	vopy
嫾	voqg
孊	vosd
嫲	voss
嬤	vosx
㚧	vot
災	vou
嬚	vouw
嫞	vovh
嫝	vovi
㜍	vovk
彛	vowa
彞	voxa
㜙	voxx
辺	vpe
婃	vpfi
㛡	vpfq
媗	vpgg
婝	vpgh
嬪	vpgm
彚	vpjs
嫇	vpju
媈	vplh
䢜	vpmp
婠	vpng
嬣	vpns
㛮	vpoc
㛽	vpoy
妉	vpqn
嬸	vptl
廵	vpv
姲	vpvg
㜚	vpwj
嫆	vpwk
㚮	vpwn
媰	vqbt
姽	vqdb
㜣	vqdo
㜬	vqdy
妳	vqiy
姰	vqjg
㛯	vqke
姁	vqkg
姳	vqkg
嬎	vqkg
嬔	vqkg
婏	vqky
㜶	vqky
㛟	vqmd
嫓	vqmx
媍	vqmy
㚿	vqnn
䲥	vqou
婅	vqoy
鳩	vqoy
鳭	vqoy
鵖	vqoy
姼	vqqy
㚹	vqtb
夛	vqu
㚬	vqug
㛀	vqvg
婙	vqvh
嬝	vqye
嬼	vqyj
媹	vqyl
奺	vqyy
㛂	vrcn
㛓	vrdh
㚱	vrg
媓	vrgg
姤	vrgk
妡	vrh
婂	vrmh
媿	vrqc
㜱	vrrm
娦	vrwy
㜰	vrxs
嬓	vryt
㛉	vsg
奵	vsh
㜀	vshg
娻	vsjg
㜁	vsjg
㜤	vsjh
妸	vskg
娕	vskg
嬾	vskm
嫰	vskw
媡	vslg
㛦	vssy
婹	vsvg
婡	vsww
雑	vswy
奼	vtan
㛢	vtbt
姡	vtdg
㛔	vtdh
嬌	vtdk
䪳	vtdm
㛼	vtfe
奷	vtfh
㜺	vtfm
娗	vtfp
姺	vtfq
娷	vtfa
媑	vtgf
姩	vtgh
嫵	vtgo
妷	vtgy
妰	vthf
嬶	vthj
娫	vthp
娳	vtjh
㪊	vtkc
裠	vtke
帬	vtkh
頵	vtkm
焄	vtko
鵘	vtko
覠	vtkq
羣	vtku
㜩	vtmd
姠	vtmk
㛛	vtmt
㜫	vtmt
嬏	vtol
姂	vtpy
㚵	vtuy
婑	vtvg
孂	vtvl
㜡	vtwh
䶯	vtxg
娒	vtxy
姀	vty
嬢	vuae
嫅	vuag
嫺	vueg
媊	vuej
嬘	vuep
婘	vugb
媄	vugd
姅	vugh
嬟	vugy
㛙	vuh
㛠	vujg
㛺	vujg
嬑	vujn
婄	vukg
娧	vukq
㜔	vukq
㛨	vunn
媨	vusg
孄	vusl
媇	vusy
嫻	vusy
嫸	vuuk
㜋	vuwl
嬨	vuxn
㜦	vvaf
㚣	vvf
嫿	vvfg
姧	vvfh
奻	vvg
嬧	vvhl
娽	vviy
㜉	vvkc
妱	vvkg
婦	vvph
㛴	vvtr
脋	vvve
姦	vvvf
刕	vvvr
妐	vwcy
婨	vwga
媕	vwga
婾	vwgb
姾	vwgg
姵	vwgh
媮	vwgj
嬒	vwgj
姶	vwgk
嬆	vwgn
㛹	vwgr
嬁	vwgu
嬐	vwgw
刅	vwi
㚷	vwiy
妎	vwjh
媬	vwks
娰	vwnw
㛋	vwny
㚯	vwry
㛊	vwsy
姙	vwtf
㜄	vwtj
妢	vwvt
㛗	vwwf
孅	vwwg
姈	vwyc
孇	vwyc
婎	vwyg
㜃	vwyg
㜝	vwyg
䧱	vwyg
娢	vwyk
嫶	vwyo
嬵	vxrh
嫋	vxuu
媘	vxxr
娹	vxyx
㛩	vyce
㜵	vyce
訄	vyd
䎠	vydj
㛄	vyey
㜲	vyey
娮	vyg
丒	vygf
妵	vygg
刄	vyi
婛	vyiy
孃	vyke
㜳	vyle
媥	vyna
姟	vynw
嫙	vyth
媯	vyto
媂	vyuh
嬂	vyuj
嫎	vyuy
嫏	vyvb
奿	vyvd
歰	vyvh
妔	vywn
㜅	vyxl
㜻	vyxn
妶	vyxy
妏	vyy
㑘	waah
僷	waas
侙	waay
俴	waay
傇	wabg
儰	waeo
㒗	waff
㒂	wafj
㒃	wafy
仜	wag
仺	wagf
㑌	wagg
㒪	wahe
儖	wahl
㒘	wahu
㑈	waiy
㒑	waiy
㒖	wajy
傼	wakg
僅	wakg
傴	wakk
儺	waky
㑤	walg
儚	walq
㒝	walw
偀	wamd
傋	wamf
僙	wamw
佢	wang
伳	wann
偞	wans
僃	waqe
僀	waqh
備	wate
憊	watn
㷶	wato
䣏	wawb
垈	wayf
帒	wayh
貸	waym
柋	ways
㒤	wbbb
倻	wbbh
㺱	wbgy
䢳	wbh
㑁	wbmh
㑙	wbnn
怹	wbnu
鸧	wbqg
佊	wby
伋	wbyy
傪	wcce
㒍	wcci
㑓	wcdc
頌	wcdm
㑷	wcex
㐷	wcgg
佁	wckg
勜	wcne
鹟	wcng
伃	wcnh
僪	wcnk
鶲	wcno
㑱	wcns
忩	wcnu
傌	wcoy
兊	wcqb
毤	wcqe
䲲	wcqo
枀	wcsu
仏	wcy
伌	wdbn
伖	wdcy
優	wdet
倀	wdey
倴	wdfa
侲	wdfe
傉	wdff
倷	wdfi
佦	wdg
侟	wdhb
偰	wdhd
伾	wdhg
仹	wdhh
傶	wdhi
俖	wdhk
伓	wdhy
凮	wdjd
㐛	wdkn
偭	wdlf
偄	wdmd
佈	wdmh
侕	wdmj
㑔	wdmy
㑯	wdmy
偧	wdqq
傆	wdri
傸	wdrr
㑸	wdsk
儮	wdth
傄	wduh
偆	wdwj
偡	wdwn
㒋	wdwr
俠	wdww
僛	wdww
倛	wdwy
㐲	wdy
㑀	wdyy
㒚	wean
俷	wecn
倗	weeg
䏌	wef
仴	weg
伹	wegg
㒜	wegw
傁	wehc
偁	wemf
僢	wepg
僾	wept
㐱	wer
倸	wesy
傜	wetb
㒡	weti
㒨	wetn
僞	weto
俀	wevg
傒	wexd
傤	wfal
儎	wfal
僨	wfam
㑢	wfcb
凨	wfci
伝	wfcy
佉	wfcy
䵾	wffc
僥	wffq
佄	wfg
仠	wfh
佱	wfhf
値	wfhn
傎	wfhw
仐	wfj
癷	wfj
儓	wfkf
舎	wfkf
舘	wfkn
鵨	wfko
舖	wfks
舗	wfks
㖚	wfkx
䧾	wfky
儥	wflm
㑲	wfmf
儔	wfnf
怤	wfnu
俧	wfny
侼	wfpb
発	wfqb
㐾	wfqn
㑍	wfsy
侾	wftb
偖	wftj
侤	wftn
倖	wfuf
㒓	wfup
姇	wfvf
倰	wfwt
佅	wfy
㑝	wgah
侀	wgaj
倵	wgay
伅	wgbn
戣	wgda
鄈	wgdb
䳫	wgdo
兪	wgeb
鄃	wgeb
㓱	wgej
儬	wgeq
覦	wgeq
歈	wgew
俵	wgey
㼶	wgey
亼	wgf
俹	wgfg
㐵	wgfh
僫	wgfn
仼	wgg
僣	wggj
儧	wggm
佂	wghg
傿	wgho
凬	wgjd
傳	wgjf
僡	wgjn
弇	wgka
郃	wgkb
鄧	wgkb
㿯	wgkb
敆	wgkc
㪧	wgkc
龕	wgkd
儾	wgke
㲪	wgke
俉	wgkg
倳	wgkh
龣	wgki
剣	wgkj
劍	wgkj
㓣	wgkj
㔁	wgkj
樖	wgkk
偪	wgkl
畣	wgkl
盫	wgkl
頜	wgkm
顩	wgkm
龥	wgkm
翖	wgkn
㥐	wgkn
鴿	wgko
鸙	wgko
䳾	wgko
邆	wgkp
䢔	wgkp
覴	wgkq
搻	wgkr
龤	wgkr
㧱	wgkr
斂	wgkt
龢	wgkt
㪉	wgkt
㪘	wgkt
侸	wgku
豋	wgku
劎	wgkv
僉	wgkw
欱	wgkw
歛	wgkw
龡	wgkw
㑒	wgkw
㰸	wgkw
䶳	wgkw
䶵	wgkw
剱	wgky
劒	wgky
劔	wgky
㽂	wgky
㽅	wgky
䧻	wgky
鄶	wglb
朇	wglf
劊	wglj
會	wglj
侖	wgma
侢	wgmf
伂	wgmh
傮	wgmj
㑹	wgmj
㑂	wgmw
儷	wgmx
倆	wgmy
債	wgmy
䒊	wgnc
侴	wgnj
㿽	wgnl
㐳	wgqn
鳳	wgqo
㓘	wgqy
厁	wgsb
䣄	wgsb
敍	wgsc
㙦	wgsf
畬	wgsl
峹	wgsm
嵞	wgsm
悆	wgsn
䳜	wgso
敘	wgst
雓	wgsy
伻	wguf
俫	wgus
俓	wgva
倢	wgvh
儞	wgwr
仾	wgxg
傃	wgxi
侇	wgxw
伕	wgy
凪	whd
仩	whg
倶	whgw
䥚	whhq
俶	whic
㑐	whiy
佔	whkg
儢	whln
偵	whmy
㒠	whqg
俔	whqn
儏	whqo
脩	whte
鞗	whtf
䩦	whtf
跾	whth
䀺	whth
絛	whti
㫦	whtj
䖺	whtj
偹	whtl
翛	whtn
倐	whto
儵	whto
焂	whto
鯈	whto
鋚	whtq
鎥	whtq
條	whts
㛜	whtv
偼	whvh
俿	whwn
佌	whxn
偨	whxs
侊	wigq
僘	wimt
㑽	wipf
儅	wipl
償	wipm
儻	wipo
㒉	wips
偗	with
仯	witt
尒	wiu
仦	wiy
㲻	wiy
儤	wjai
㑠	wjcf
偍	wjgh
偒	wjgr
敒	wjht
㖋	wjkx
僈	wjlc
傝	wjng
䲸	wjqo
㑥	wjqr
㰡	wjqw
儑	wjxo
倱	wjxx
偮	wkbg
俋	wkcn
㕣	wkf
㐰	wkg
侱	wkgg
僓	wkhm
儙	wkhp
僤	wkkf
偘	wkkk
偔	wkkn
僺	wkks
儼	wkkt
諐	wkky
傊	wkmy
俁	wknd
兌	wkqb
㑆	wkqn
敓	wkqt
賲	wksm
㷛	wkso
䳰	wkso
㑨	wktd
侶	wktk
伿	wkwy
個	wldg
侽	wlet
㒁	wlff
伵	wlg
㑭	wlgj
伡	wlh
俥	wlh
佪	wlkg
㒦	wllf
儽	wlli
偲	wlny
僆	wlpy
㒔	wlqj
㑩	wlqy
㑼	wltk
僌	wlty
僂	wlvg
傫	wlxi
儸	wlxy
儂	wmae
㑋	wmag
僼	wmau
倎	wmaw
偳	wmdj
㒥	wmdu
佒	wmdy
傰	wmee
傦	wmeg
伷	wmg
凧	wmhk
仚	wmj
側	wmjh
儩	wmjr
伣	wmqn
㑕	wmqy
儶	wmwk
侺	wmwn
㒞	wmwn
㐻	wmwy
僝	wnbb
㒈	wnbt
佀	wng
㑚	wngb
偓	wngf
偦	wnhe
㠩	wnkb
偉	wnkg
㐶	wnn
侷	wnnk
僎	wnnw
鄇	wntb
䫛	wntm
佖	wntt
偋	wnua
亾	wnv
僇	wnwe
㒛	wnwy
伈	wny
侭	wnyu
伬	wnyy
癶	wnyy
㑞	woah
儣	woaw
儍	wobt
㶡	woi
僗	wooe
儝	woos
㒌	woow
倓	wooy
僯	woqg
侂	wota
㒒	wouf
僕	woug
傭	wovh
傏	wovk
㒣	wown
儦	woxo
侎	woy
僿	wpaf
㒏	wpau
倧	wpfi
俒	wpfq
㑏	wpfy
傢	wpge
儐	wpgm
㑮	wplh
㑻	wpnm
儜	wpns
倇	wpqb
佇	wpsh
俕	wpsy
侘	wpta
侒	wpvg
傛	wpwk
僒	wpwk
伔	wpwn
傕	wpwy
尣	wqb
㑳	wqbt
佹	wqdb
㒄	wqdo
釡	wqf
尩	wqgd
䝇	wqge
傑	wqgs
侚	wqjg
佲	wqkg
俛	wqkq
儳	wqky
偩	wqmy
佨	wqnn
鳯	wqoi
尦	wqqy
伆	wqrt
俇	wqtg
伨	wqug
㑇	wqvg
㐸	wqwy
㐴	wqy
㑾	wqyg
仢	wqyy
爺	wrbb
仮	wrcy
倄	wrde
俙	wrdh
㸖	wreg
㒶	wrf
偱	wrfh
㸙	wrfj
偟	wrgg
伒	wrh
㐿	wrh
飐	wrhk
傂	wrhw
飔	wrln
㸘	wrls
㸗	wrmk
㐹	wrn
飏	wrnr
㑶	wroy
飗	wrql
俽	wrqw
㑜	wrrh
儨	wrrm
㑟	wrwy
儌	wryt
僊	wsdn
僄	wsfi
価	wsg
凩	wsi
倲	wsjg
㑛	wskg
價	wsmy
恷	wsnu
烋	wsou
僲	wsqg
鵂	wsqo
儊	wssh
僸	wssi
㑣	wssy
偠	wsvg
倯	wswc
倈	wsww
俌	wsy
㐼	wtah
仛	wtan
㑧	wtbg
俬	wtcy
㒎	wgdd
佸	wtdg
倁	wtdk
僑	wtdk
仸	wtdy
俢	wtet
偛	wtfe
偫	wtff
䣸	wtfg
䋕	wtfi
俈	wtfk
儹	wtfm
賃	wtfm
鵀	wtfo
㶵	wtfo
侹	wtfp
侁	wtfq
栠	wtfs
働	wtge
倂	wtgf
倕	wtfa
偅	wtgf
儛	wtgg
佭	wtgh
㒇	wtgo
㑅	wthg
㑑	wthg
偺	wthj
倃	wthk
㤰	wthn
䫹	wtja
䬙	wtjb
颼	wtjc
䬒	wtjc
䬜	wtjc
颳	wtjd
飇	wtjd
颩	wtje
颵	wtje
飂	wtje
䫽	wtje
䬀	wtje
䬅	wtje
䬑	wtje
䬞	wtjf
颫	wtjg
颹	wtjg
䬄	wtjg
䬎	wtjg
䬖	wtjg
䬛	wtjg
颴	wtjh
風	wtji
飃	wtji
飉	wtji
颲	wtjj
颾	wtjj
飍	wtjj
䫻	wtjj
䬆	wtjj
䬓	wtjj
䬔	wtjj
䬕	wtjj
䬟	wtjj
颭	wtjk
颱	wtjk
䫿	wtjk
䬏	wtjk
䬘	wtjk
飀	wtjl
飅	wtjl
颮	wtjn
颸	wtjn
䬂	wtjn
䬍	wtjn
颷	wtjo
飈	wtjo
䬉	wtjo
䬚	wtjo
䬈	wtjq
傷	wtjr
颺	wtjr
颬	wtjt
飋	wtjt
䫾	wtjt
䬋	wtjt
䬃	wtju
䫸	wtjv
䬐	wtjv
颶	wtjw
䫼	wtjw
䬊	wtjw
䬝	wtjw
䬁	wtjx
颰	wtjy
佫	wtkg
俰	wtkg
偊	wtky
侐	wtlg
俻	wtlg
傯	wtln
㑗	wtmt
僠	wtol
僁	wton
僽	wton
偢	wtoy
㒐	wtqj
侜	wtuy
傱	wtwh
係	wtxi
傞	wuag
併	wuah
儱	wued
僩	wueg
偂	wuej
們	wug
儯	wugo
儀	wugy
偣	wujg
僴	wujg
傽	wujh
億	wujn
傹	wujq
侻	wukq
佽	wuqw
俲	wure
傚	wurt
僔	wusf
偤	wusg
儭	wusq
㑵	wutd
偐	wute
仒	wuu
傡	wuug
僐	wuuk
倿	wuvg
傔	wuvw
凲	wuvw
偝	wuxe
俤	wuxt
餞	wvaa
饃	wvad
䭊	wvad
饛	wvae
䭦	wvaf
饉	wvag
弅	wvaj
䭙	wvaj
饇	wvak
饚	wval
餀	wvar
䭎	wvas
䭟	wvas
饊	wvat
餝	wvay
餌	wvbg
邠	wvbh
㑡	wvbh
飿	wvbm
餟	wvcc
飴	wvck
餕	wvct
伮	wvcy
餴	wvda
餪	wvdd
餦	wvde
餬	wvde
䭉	wvde
㑬	wvdg
䬪	wvdh
䭜	wvdi
頒	wvdm
餣	wvdn
餿	wvec
饀	wvee
飷	wveg
䭡	wven
餒	wvev
䬻	wvfa
餑	wvfb
伜	wvfh
飦	wvfh
饎	wvfk
饁	wvfl
饙	wvfm
饒	wvfq
䬧	wvfq
饐	wvfu
㚢	wvg
饢	wvge
䬹	wvgf
侓	wvgh
䭄	wvgh
䭍	wvgl
飩	wvgn
䬴	wvgs
餖	wvgu
瓫	wvgy
饖	wvhh
䬯	wvhk
儘	wvhl
饄	wvif
饓	wvis
饅	wvjc
饆	wvjg
䭘	wvji
饂	wvjl
餲	wvjn
餳	wvjr
餜	wvjs
㑿	wvjs
蚠	wvju
餛	wvjx
蝕	wvjy
䭂	wvkc
䬼	wvke
佋	wvkg
侞	wvkg
饋	wvkm
䭤	wvkp
兺	wvkx
㖌	wvkx
䭅	wvld
餵	wvle
䭞	wvlf
儠	wvln
饠	wvly
䬬	wvmd
餶	wvme
㑎	wvmh
餇	wvmk
䭨	wvmk
貧	wvmu
䭓	wvmu
䬿	wvne
飼	wvnk
䭀	wvnp
飶	wvnt
䭛	wvnt
饌	wvnw
䬮	wvnw
饝	wvod
䭩	wvod
䭧	wvoi
餹	wvok
餤	wvoo
䭖	wvoo
炃	wvou
䭠	wvow
麄	wvox
㑴	wvpc
餫	wvpl
館	wvpn
䭢	wvps
飹	wvqb
餡	wvqe
餆	wvqi
䬲	wvqk
䭇	wvqk
餾	wvql
飽	wvqn
鳻	wvqo
䬷	wvqq
䬨	wvqv
飲	wvqw
饞	wvqy
䬫	wvqy
飯	wvrc
餽	wvrc
餚	wvre
餭	wvrg
餙	wvrh
餼	wvro
餺	wvsf
餷	wvsg
䬱	wvsg
飣	wvsh
餗	wvsk
餔	wvsy
飥	wvta
飫	wvtd
餂	wvtd
飭	wvte
飪	wvtf
飵	wvtf
餠	wvtf
飾	wvth
侰	wvtk
餉	wvtk
餎	wvtk
饡	wvtm
䬣	wvtn
䭒	wvtn
䭔	wvtp
餰	wvts
餧	wvtv
攽	wvty
飠	wvty
餓	wvty
餅	wvua
䭚	wvuf
饈	wvug
䬳	wvug
䬺	wvuh
餢	wvuk
饍	wvuk
䭐	wvun
餻	wvuo
餸	wvup
䬽	wvuq
䭗	wvuq
餃	wvur
䬾	wvut
䭥	wvuv
䭑	wvuw
䬰	wvvk
䭈	wvvp
䬢	wvvt
䬶	wvvy
䬦	wvwc
餱	wvwd
飻	wvwe
餁	wvwf
䭝	wvwj
餄	wvwk
飢	wvwn
䭃	wvwn
餘	wvws
䭋	wvws
餩	wvww
飤	wvwy
餯	wvxe
饑	wvxw
佷	wvy
䭏	wvya
餏	wvye
饟	wvye
飳	wvyg
饘	wvyg
飰	wvyh
㒊	wvyh
䭣	wvyj
䬵	wvyw
仭	wvyy
韱	wwag
㦰	wwai
倊	wwcn
傟	wwcn
癹	wwcu
伀	wwcy
伇	wwcy
剉	wwfj
倽	wwfk
夎	wwft
倫	wwga
㒢	wwga
偸	wwgb
佺	wwgg
儈	wwgj
佮	wwgk
㒆	wwgn
㑉	wwgq
俆	wwgs
僜	wwgu
倹	wwgw
儉	wwgw
睂	wwhh
伱	wwiy
谾	wwka
䜫	wwka
卻	wwkb
郤	wwkb
谹	wwkc
䜱	wwkc
豀	wwkd
豅	wwkd
豂	wwke
䜰	wwkf
谻	wwkg
䜮	wwkg
㑖	wwkh
螸	wwkj
谽	wwkk
豄	wwkm
䜬	wwkm
慾	wwkn
䜲	wwkn
鵒	wwko
䜯	wwko
逧	wwkp
谺	wwkt
豃	wwkt
䜪	wwkv
谼	wwkw
㞃	wwky
佡	wwmh
㐽	wwry
偑	wwtj
仌	wwu
侳	wwwf
傘	wwwf
䁞	wwwh
㫺	wwwj
㐺	wwwy
仈	wwy
㑺	wwyb
倠	wwyg
傖	wwyk
僋	wwym
仱	wwyn
儁	wwyn
㑫	wwyn
㺸	wwyy
傾	wxdm
㒩	wxej
㑃	wxet
㑰	wxey
僶	wxg
伄	wxhh
貨	wxmu
㒙	wxrh
儗	wxth
發	wxwc
㔇	wxwj
僟	wxxw
㑄	wxy
䨇	wywc
俼	wyce
㒟	wyce
鸰	wycg
刢	wycj
領	wycm
鴒	wyco
隻	wycu
顀	wydm
㥋	wyen
偯	wyey
詧	wyf
儲	wyfj
鶽	wyfo
傠	wyfy
雋	wyhn
倞	wyiy
儕	wyjg
㑪	wyjg
儴	wyke
儃	wylg
傐	wymk
侌	wync
㪁	wync
㑦	wynd
酓	wyng
韽	wynj
㓧	wynj
盦	wynl
貪	wynm
頷	wynm
傓	wynn
䎏	wynn
鳹	wyno
䳺	wyno
敜	wynt
侫	wynv
侅	wynw
欦	wynw
㱃	wynw
僱	wyny
雂	wyny
㼨	wyny
䨄	wyny
㲬	wyoe
顦	wyom
鷦	wyoo
㑊	wyoy
進	wypd
儫	wype
㒅	wyqe
燞	wyqo
䳡	wyqo
㒧	wyry
偽	wyto
倣	wyty
亽	wyu
㒀	wyud
偙	wyuh
䧶	wyuu
戧	wyva
創	wyvj
倉	wyvk
鶬	wyvo
䢢	wyvp
飮	wyvw
俍	wyvy
雙	wywc
倅	wywf
犨	wywg
䨊	wywg
㸈	wywo
雧	wyws
讐	wywy
雔	wywy
雥	wywy
雦	wywy
傗	wyxl
伭	wyxy
㒕	wyxy
伩	wyy
犫	wyyg
㘜	wyyk
讎	wyyy
綫	xaay
縙	xabg
絨	xadt
繖	xaet
緙	xafh
紅	xag
䌑	xahf
弫	xahh
弬	xahh
䋗	xahh
繿	xahl
纜	xahq
䌫	xahq
縸	xajd
緎	xakg
䌍	xakg
彄	xakk
䌔	xakk
䌯	xaky
緢	xalg
䌩	xalw
緓	xamd
绬	xamd
彉	xamw
䌙	xamw
弡	xang
䋌	xang
紲	xann
䋐	xann
弽	xans
緤	xans
㣅	xaqj
繱	xaqn
㣁	xate
䌲	xato
纄	xatp
䌨	xawi
䌋	xawk
䌭	xawo
䌰	xbbb
䋼	xbcl
緅	xbcy
㝀	xbg
䋙	xbg
䌺	xbg
鄳	xbh
弢	xbhc
絀	xbmh
毑	xbn
䊶	xbn
䋪	xbsk
㢽	xbxn
紴	xby
㢰	xby
級	xbyy
綴	xccc
縿	xcce
縔	xccs
経	xcfg
㢱	xciy
䥒	xcjq
強	xcjy
紿	xckg
緿	xckn
弝	xcn
紦	xcn
紓	xcnh
繘	xcnk
䋴	xcns
䋒	xcnt
紁	xcyy
紘	xdcy
紱	xdcy
纮	xdcy
㢬	xdcy
絠	xdeg
纋	xdet
張	xdey
縟	xdff
絝	xdfn
緘	xdgk
縅	xdgv
䋔	xdhg
縬	xdhi
紑	xdhy
緾	xdjf
絔	xdjg
㢶	xdjg
緬	xdlf
緛	xdmd
頃	xdmy
䋶	xdmy
絾	xdnn
紌	xdny
䋾	xdqq
縓	xdri
綺	xdsk
綁	xdtb
繚	xdui
縥	xdwt
綊	xdww
綨	xdwy
紎	xdy
䌥	xean
孧	xebf
綒	xebg
弸	xeeg
綳	xeeg
縚	xeeg
緩	xegc
組	xegg
䌐	xehq
剶	xejh
劙	xejj
䗍	xeju
盠	xelf
䋃	xen
綬	xepc
䋩	xeqn
鴢	xeqo
鶨	xeqo
綵	xesy
䌽	xesy
糼	xet
絼	xet
䌊	xetb
綏	xevg
縘	xexd
纎	xfag
繊	xfao
駂	xfco
紜	xfcy
紶	xfcy
繻	xfdj
繧	xffc
䋽	xfff
絓	xffg
繞	xffq
紺	xfg
㢨	xfh
縝	xfhw
㣀	xfhw
頴	xfim
颕	xfim
結	xfkg
繥	xfkk
纈	xfkm
續	xflm
䋻	xfmf
䌾	xfmf
䌧	xfnf
㢪	xfnn
䊸	xfnn
綕	xfny
䌸	xfny
綍	xfpb
䌇	xfpi
続	xfpq
鴇	xfqo
䌮	xfsh
䋘	xfsy
䰞	xfth
緒	xftj
緖	xftj
䊷	xftt
䌶	xftt
緈	xfuf
盭	xful
繨	xfup
䌢	xfwc
繬	xfwk
綾	xfwt
紂	xfy
純	xgbn
絰	xgcf
绖	xgcf
緻	xgct
㢧	xgd
䋬	xgdn
綪	xgeg
弖	xgf
弙	xgfh
紆	xgfh
纉	xggm
絚	xghg
䋊	xghg
絿	xgiy
縳	xgjf
絙	xgjg
繐	xgjn
綆	xgjr
㣂	xgkh
䋹	xgkl
䌿	xgkl
䰜	xgkx
彊	xglg
繮	xglg
弻	xglx
䌄	xgmc
䋑	xgmw
纚	xgmx
緉	xgmy
績	xgmy
縉	xgoj
弳	xgva
經	xgva
緁	xgvh
緀	xgvv
㣆	xgwg
䥸	xgwq
彌	xgwr
䌤	xgwr
㜷	xgwv
瓕	xgwy
䌳	xgwy
䊺	xgxg
縤	xgxi
䊿	xgy
㢭	xhcy
緋	xhdd
䊼	xhg
彏	xhhc
緲	xhit
綽	xhjh
弔	xhk
盄	xhlf
纑	xhll
緽	xhmy
顚	xhnm
鷆	xhno
眞	xhnw
繉	xhqi
絸	xhqn
紪	xhxn
㣄	xias
潁	xidm
弰	xieg
綃	xieg
䌃	xiej
絖	xigq
弾	xijf
剝	xijh
緔	ximk
紗	xitt
彔	xiu
䋝	xivg
㢼	xiy
彃	xjag
縪	xjag
繓	xjbc
㔗	xjet
䋥	xjfg
䋎	xjgg
緹	xjgh
㔭	xjgh
紳	xjhh
縨	xjiq
㔬	xjj
刜	xjjh
縄	xjjn
縵	xjlc
緼	xjlg
缊	xjlg
鄪	xjmb
費	xjmu
䌈	xjng
絏	xjnt
㡫	xjqn
䋵	xjqn
鴲	xjqo
緆	xjqr
綶	xjsy
䍀	xjtl
㪄	xjty
䭫	xjuh
䭬	xjvh
緄	xjxx
緝	xkbg
弲	xkeg
絹	xkeg
紃	xkh
繢	xkhm
繾	xkhp
勥	xkje
䋲	xkjn
謽	xkjy
彈	xkkf
繟	xkkf
絽	xkkg
繰	xkks
縜	xkmy
絪	xldy
緭	xleg
繹	xlff
纆	xlff
細	xlg
彋	xlge
繯	xlge
䋿	xlge
䌉	xlgh
綥	xlgj
絗	xlkg
纝	xlli
緦	xlny
縺	xlpy
㢴	xlry
綑	xlsy
縷	xlvg
縕	xlwl
縲	xlxi
轡	xlxk
纙	xlxy
繷	xmae
䌡	xmau
紻	xmdy
繃	xmee
縎	xmeg
綢	xmfk
紬	xmg
䌷	xmg
絧	xmgk
㢫	xmh
絅	xmkg
䌹	xmkg
纓	xmmv
緺	xmnk
遦	xmpi
㢷	xmqy
䋞	xmrr
䋄	xmry
貫	xmu
綱	xmum
網	xmun
綗	xmwk
纗	xmwk
納	xmwy
繀	xmwy
緡	xnaj
㢯	xnan
䋋	xnan
䋧	xndg
䋚	xng
䌻	xng
䌂	xngf
緪	xngg
縆	xngg
縀	xnhc
縃	xnhe
紐	xnhg
糾	xnhh
䌵	xnij
緯	xnkg
䌟	xnku
乣	xnn
糺	xnn
紀	xnn
彑	xnng
黽	xnng
毌	xnnh
繏	xnnw
糹	xnny
䋟	xnny
䌌	xnrg
繆	xnwe
䊽	xnwy
䌦	xnwy
䋇	xnyy
彍	xoaw
纊	xoaw
絋	xocy
熲	xodm
颎	xodm
纏	xojf
纒	xojf
継	xonn
緂	xooy
繗	xoqg
䌕	xoss
䌜	xouf
䌅	xovk
彜	xowa
䌒	xoxx
䋛	xoy
綋	xpdc
縖	xpdk
綜	xpfi
綄	xpfq
縇	xpgg
纻	xpgg
綻	xpgh
繽	xpgm
縯	xpgw
彙	xpjs
緷	xplh
綰	xpng
䌏	xpnm
綩	xpqb
紞	xpqn
紵	xpsh
縡	xpuh
縮	xpwj
䋉	xpwy
紽	xpxn
緍	xqaj
紙	xqan
弤	xqay
縐	xqbt
㔢	xqce
絶	xqcn
㔃	xqcv
繎	xqdo
繲	xqeg
䋮	xqg
絩	xqiy
絢	xqjg
絇	xqkg
絻	xqkq
纔	xqky
䳇	xqoy
緫	xqrn
綯	xqtb
绹	xqtb
䋓	xqvg
䋫	xqvh
繺	xqvo
弞	xqwy
䊻	xqwy
約	xqyy
㢩	xqyy
緵	xrbt
絺	xrdh
䋸	xrfh
絈	xrg
紤	xrh
線	xriy
缐	xriy
綿	xrmh
㣇	xrmh
㣈	xrmh
䌆	xrqc
䋂	xrry
綼	xrtf
纅	xrxs
繳	xryt
㯋	xsdm
緸	xsfg
㢾	xsfg
縹	xsfi
縛	xsfy
絤	xsg
絊	xsgg
綇	xsgg
糽	xsh
緗	xshg
綀	xskg
䋍	xskg
彁	xskk
練	xslg
䌚	xsoy
䌝	xssi
綝	xssy
䌁	xsvg
䋱	xsww
䊾	xsy
䋠	xsy
絉	xsyy
鄊	xtbb
絁	xtbn
㢮	xtbn
綉	xtbt
觺	xtde
絬	xtdg
綘	xtdh
繑	xtdk
穎	xtdm
縫	xtdp
欵	xtdw
矤	xtdy
㽈	xtdy
㢳	xtey
紝	xtfg
纴	xtfg
䊹	xtfh
纘	xtfm
綎	xtfp
絑	xtfy
綞	xtfa
緟	xtgf
絳	xtgh
䋅	xtgh
纁	xtgo
䌗	xtgo
絎	xtgs
紩	xtgy
緞	xthc
䋏	xthf
縰	xthh
綹	xthk
綖	xthp
緮	xtjt
蚃	xtju
絡	xtkg
總	xtln
繌	xtlt
紇	xtnn
縋	xtnp
繙	xtol
䋺	xtoy
䌣	xtpn
鄕	xtrb
䌀	xtuf
縦	xtuh
終	xtuy
郷	xtvb
緌	xtvg
㢻	xtvg
縱	xtwh
䋦	xtxy
鄉	xtyb
蠁	xtyj
響	xtyj
嚮	xtyk
㗽	xtyk
饗	xtyv
縒	xuag
絣	xuah
縌	xubp
䌬	xued
繝	xueg
繸	xuep
䍁	xuep
彅	xuev
紏	xufh
綣	xugb
絆	xugh
絴	xuh
㢹	xuh
繶	xujn
䋨	xukg
縂	xukn
綐	xukq
䌼	xukq
繒	xulj
䌪	xuqe
絘	xuqw
纐	xurm
絞	xury
繜	xusf
緧	xusg
繕	xuuk
㢺	xuvg
縑	xuvw
縊	xuwl
䋳	xuxe
鶸	xuxo
綈	xuxt
絕	xvcn
縁	xvey
繣	xvfg
紣	xvfh
彇	xvfj
繡	xvfj
䋖	xvgh
緑	xviy
繅	xvjs
弨	xvkg
紹	xvkg
緇	xvlg
䊵	xvn
繍	xvoj
綅	xvpc
糿	xvt
㓜	xvt
匘	xvtr
綛	xvyn
紈	xvyy
紉	xvyy
総	xwcn
絥	xwdy
紾	xwet
絵	xwfc
縩	xwfi
弣	xwfy
紨	xwfy
綸	xwga
絟	xwgg
緰	xwgj
繪	xwgj
給	xwgk
㢵	xwgk
緶	xwgr
䋡	xwgs
䌞	xwgw
縧	xwhs
紒	xwjh
緥	xwks
緱	xwnd
㢿	xwnd
纀	xwog
絍	xwtf
紛	xwvt
纖	xwwg
緃	xwwh
綌	xwwk
绤	xwwk
紷	xwyc
維	xwyg
䗽	xwyj
紟	xwyn
䌖	xwys
㡬	xxaq
㡮	xxar
幾	xxaw
㿫	xxbu
繈	xxcj
紭	xxcy
毞	xxeb
緣	xxey
㩺	xxfc
坒	xxff
繩	xxg
㡭	xxgn
斷	xxgr
㫁	xxgr
㢲	xxgw
紖	xxhh
纼	xxhh
顈	xxim
鷥	xxio
絲	xxiy
綠	xxiy
紼	xxjh
繦	xxkj
弜	xxn
粊	xxou
勓	xxre
鶛	xxro
枈	xxsu
㢸	xxty
紕	xxxn
繼	xxxn
䘡	xxye
弴	xybg
綧	xybg
䋭	xyce
統	xycq
㣃	xycx
袰	xyeu
䌱	xyey
䌴	xyey
紸	xygg
弶	xyiy
綡	xyiy
緕	xyjg
纃	xyjg
縗	xyke
纕	xyke
缞	xyke
繵	xylg
縞	xymk
編	xyna
綟	xynd
䋆	xynt
絯	xynw
綂	xyqn
鶭	xyqo
縭	xyrc
紡	xyt
絒	xyth
縼	xyth
締	xyuh
織	xyuj
縍	xyuy
綷	xywf
䋁	xywn
繂	xyxf
縴	xyxg
纞	xyxn
婱	xyxv
絃	xyxy
紋	xyy
誡	yaah
䜓	yaas
試	yaay
諓	yaay
諾	yadk
讛	yafc
諽	yafh
訌	yag
誆	yagg
譁	yagg
衺	yahe
訝	yaht
謨	yajd
諎	yajg
譪	yajn
䜕	yajy
謹	yakg
謳	yakk
讌	yako
䜩	yako
讙	yaky
講	yamf
詎	yang
詍	yann
諜	yans
譖	yaqj
䜦	yaqj
䜘	yaqt
護	yawc
誣	yaww
誮	yawx
䜤	yawy
謊	yayk
讘	ybbb
諏	ybcy
䜏	ybde
讔	yben
斈	ybf
斊	ybf
誀	ybg
㝄	ybgn
詜	ybhc
㓙	ybk
嚲	ybkf
詘	ybmh
訑	ybn
鶉	ybqo
䚮	ybt
䃦	ybtd
墪	ybtf
鐜	ybtq
撉	ybtr
亸	ybuf
䃞	ybvd
詖	yby
诐	yby
㝇	ybyb
訯	ybyy
棄	ycas
諁	yccc
謲	ycce
誦	yceh
逳	ycep
裛	yceu
旀	yciy
㐬	yckb
袬	ycke
詒	yckg
夣	yclq
譎	ycnk
褭	ycoe
誒	yctd
誜	ycwt
訍	ycyy
䜔	ydap
詙	ydcy
詴	ydeg
顏	ydem
彥	yder
䜡	ydet
䛫	ydey
誫	ydfe
譇	ydfj
誇	ydfn
詁	ydg
諴	ydgk
䜗	ydgn
㕻	ydhk
譿	ydhn
䛶	ydhs
䛳	ydjn
䛔	ydmj
誠	ydnn
訧	ydny
詼	ydoy
謜	ydri
旑	ydsk
䛴	ydsk
䫯	ydsm
诪	ydtf
產	ydtg
讈	ydth
䜍	ydui
諶	ydwn
䛟	ydww
諆	ydwy
䛋	ydy
譭	yeac
䛼	yeag
驘	yecy
彣	yee
謟	yeeg
䘚	yefj
䚴	yeg
諼	yegc
詛	yegg
謏	yehc
臝	yejy
亹	yemg
斖	yemg
贏	yemy
䚽	yen
䊨	yeow
䛵	yepc
誽	yeqn
鸁	yeqy
䚲	yet
謡	yetb
譌	yeto
䇔	yeuy
諛	yewy
謑	yexd
䜟	yfag
詓	yfcy
䚳	yfcy
譳	yfdj
䜁	yffd
詿	yffg
謣	yffn
譊	yffq
詩	yffy
詌	yfg
計	yfh
訐	yfh
謓	yfhw
謿	yfje
詰	yfkg
譆	yfkk
讀	yflm
讟	yfly
諵	yfmf
譸	yfnf
誌	yfny
誖	yfpb
読	yfpq
䛃	yfqn
誄	yfsy
謀	yfsy
誟	yftb
諸	yftj
䙝	yfue
䛭	yfuf
褻	yfwe
対	yfy
討	yfy
訮	ygah
贇	ygam
赟	ygam
訰	ygbn
誈	ygcf
詽	ygdf
䚶	ygdy
請	ygeg
諑	ygey
諘	ygey
䛩	ygfg
訏	ygfh
䜑	ygfn
譛	yggj
讃	yggm
証	yghg
㪯	ygj
譓	ygjn
語	ygkg
䛿	ygkh
讍	ygkk
諨	ygkl
䛠	ygku
䜊	ygmj
謮	ygmy
瓬	ygny
迬	ygpd
謸	ygqt
評	yguf
誙	ygva
誱	ygvh
殶	ygwc
䛾	ygxi
謔	yhag
誹	yhdd
裵	yhde
韲	yhdg
䥆	yhdq
謯	yheg
訨	yhg
讞	yhgd
諔	yhic
詀	yhkg
譃	yhog
䜜	yhph
斍	yhqb
誢	yhqn
謼	yhtf
諕	yhwn
訿	yhxn
訃	yhy
蹵	yidh
鷲	yido
誚	yieg
勍	yiet
氷	yii
誻	yijg
剠	yijh
㙶	yipf
譡	yipl
讜	yipo
鶁	yiqo
訬	yitt
䚱	yiy
斔	yjew
亯	yjf
斉	yjf
齊	yjf
裏	yjfe
䛞	yjfh
髙	yjfk
詚	yjgg
諟	yjgh
䜥	yjgp
諹	yjgr
䚯	yjh
齏	yjhg
訷	yjhh
亰	yjiu
斎	yjiu
齋	yjiu
亣	yjj
誯	yjjg
剤	yjjh
劑	yjjh
䘇	yjjj
螡	yjju
螤	yjjw
謾	yjlc
齍	yjlf
齎	yjmu
䛖	yjnt
恴	yjnu
齌	yjou
謁	yjqn
䛕	yjry
課	yjsy
謃	yjtg
㚆	yjtu
㪟	yjty
蚉	yju
䶒	yjvf
䜙	yjxo
䛰	yjxx
諿	ykbg
誤	ykgd
㲤	ykge
訓	ykh
訲	ykhh
䜋	ykhm
䛱	ykhn
譴	ykhp
讉	ykhp
䛤	ykhy
勷	ykke
譂	ykkf
諤	ykkn
䜨	ykkn
譟	ykks
讝	ykkt
詋	ykqn
㐯	yktj
䛊	ykwy
㖜	ykxb
畆	ylcy
謂	yleg
畗	ylf
譯	ylff
訵	ylg
譞	ylge
䛅	ylh
褱	ylie
䜚	ylip
皽	ylkb
勯	ylke
氈	ylke
㐭	ylkf
䯬	ylkf
亶	ylkg
鹯	ylkg
䛛	ylkg
㔊	ylkj
顫	ylkm
鸇	ylko
邅	ylkp
稟	ylkt
讄	ylll
諰	ylny
謰	ylpy
畝	ylqy
謱	ylvg
䛺	ylwj
謖	ylwt
畒	ylwy
譨	ymae
諯	ymdj
詇	ymdy
䛁	ymfg
調	ymfk
䛆	ymg
詷	ymgk
䛣	ymgn
訕	ymh
髜	ymka
鄗	ymkb
毃	ymkc
䯩	ymkc
䯨	ymkd
髝	ymke
㙜	ymkf
詗	ymkg
诇	ymkg
䯪	ymkm
鶮	ymko
槀	ymks
髞	ymks
稾	ymkt
㪣	ymkt
髛	ymkv
歊	ymkw
髚	ymkw
諣	ymnk
誷	ymun
讗	ymwk
䐡	ymww
訥	ymwy
䜅	ymwy
肈	ynag
䁉	ynah
䋯	ynai
啔	ynak
䛉	ynan
㐎	ynb
㐔	ynb
誳	ynbm
譀	ynbt
㦾	ynbv
㧀	ynby
䋜	ynci
㪐	yndc
䛯	yndg
戻	yndi
顅	ynem
鵳	yneo
㧁	ynfc
訊	ynfh
詡	yng
詞	yngk
諝	ynhe
谞	ynhe
䚼	ynhg
訆	ynhh
扂	ynhk
䛝	ynhm
㐧	ynht
䜄	ynig
朚	ynje
蝱	ynjj
䖟	ynju
巟	ynkb
諱	ynkg
啟	ynkt
㧂	ynld
㲢	ynme
帍	ynmh
㠵	ynmh
㓲	ynmj
騗	ynmo
鶣	ynmo
甂	ynmy
㼐	ynmy
記	ynn
戺	ynnn
焈	ynno
戹	ynnv
譔	ynnw
誋	ynny
扊	ynoo
鳸	ynqo
扅	ynqq
謵	ynrg
㦿	ynsi
杗	ynsu
郂	yntb
㱾	yntc
䏿	ynte
䁈	ynth
晵	yntj
啓	yntk
扄	yntk
衁	yntl
謐	yntl
賌	yntm
頦	yntm
棨	ynts
䛑	yntt
欬	yntw
忞	ynu
悥	ynu
謘	ynuh
肁	ynvg
謬	ynwe
顧	ynwm
訣	ynwy
䋀	ynxi
䛏	ynxn
訫	yny
扆	ynye
訳	ynyy
謶	yoao
亪	yogy
䛸	yohk
帟	yomh
䛧	yonn
䜎	yooe
爕	yooo
夑	yoot
談	yooy
㽊	yooy
謎	yopy
鵉	yoqo
変	yotu
㪰	you
譵	youf
譧	youw
詸	yoy
這	ypd
䜢	ypdn
䢍	ype
誼	ypeg
誴	ypfi
亴	ypfv
諠	ypgg
諚	ypgh
谉	ypjh
諢	yplh
䯧	ypmk
䛷	ypqb
訦	ypqn
詝	ypsh
詫	ypta
讅	yptl
稁	yptu
䛪	ypwx
䛎	ypwy
詑	ypxn
諙	yqaj
䛡	yqak
詆	yqay
䛄	yqbn
謅	yqbt
詭	yqdb
㫉	yqdb
譫	yqdy
諂	yqeg
椉	yqgs
謋	yqgs
誂	yqiy
詢	yqjg
訽	yqkg
詺	yqkg
䜛	yqkq
讒	yqky
㪱	yqmd
讂	yqmt
袌	yqne
䛌	yqnn
鴍	yqou
諊	yqoy
鳼	yqoy
鴋	yqoy
袲	yqqe
誃	yqqy
詾	yqrb
謠	yqtb
䛬	yqtb
誑	yqtg
諍	yqvh
䚿	yqwy
訋	yqyy
訩	yrbh
讻	yrbh
㐫	yrbj
離	yrby
䛀	yrcy
誵	yrde
䜂	yrdf
䛥	yrdh
䛻	yrfh
諻	yrgg
詬	yrgk
訢	yrh
䜣	yrh
謕	yrhw
䛲	yrmh
謉	yrqc
褢	yrqe
䜠	yrrm
訤	yrry
諀	yrtf
譤	yryt
訴	yryy
諲	ysfg
謤	ysfi
訂	ysh
諌	ysjg
譚	ysjh
訶	yskg
誎	yskg
謌	yskk
諫	yslg
䜖	ysmy
諃	yssy
䜉	yswi
誺	ysww
誧	ysy
訹	ysyy
䛂	ytah
託	ytan
讬	ytan
斿	ytbg
䗐	ytbj
䞄	ytbm
遊	ytbp
誘	ytbt
旇	ytby
話	ytdg
譑	ytdk
訞	ytdy
䛈	ytdy
旟	ytew
膐	ytew
䛽	ytfe
䚾	ytfg
許	ytfh
誥	ytfk
讚	ytfm
誔	ytfp
詵	ytfq
誅	ytfy
袠	ytge
諈	ytfa
諥	ytgf
㫌	ytgh
譕	ytgo
旊	ytgy
詄	ytgy
詐	ythf
詯	ythg
䛮	ythk
誕	ythp
旓	ytie
誗	ytjh
詻	ytkg
謥	ytln
䛜	ytlr
䜒	ytmd
謝	ytmf
㫋	ytmf
斾	ytmh
䗠	ytnj
訖	ytnn
為	ytno
旙	ytol
譒	ytol
䢟	ytpi
㫎	ytpl
旐	ytqi
謻	ytqq
旂	ytrh
誐	ytry
旚	ytsi
㫊	ytsk
㫏	ytsv
旛	yttl
鷟	ytto
旞	ytup
諉	ytvg
旍	ytwc
旝	ytwj
譗	ytwk
斻	ytwn
䛢	ytwn
㫍	ytwt
誨	ytxy
訸	yty
䚺	yty
旜	ytyg
譲	yuae
誁	yuah
戠	yuaj
䜇	yuce
譋	yueg
譾	yuen
譢	yuep
謭	yuev
䚵	yufh
詊	yugh
議	yugy
詳	yuh
䛨	yuh
諳	yujg
譩	yujn
説	yukq
譄	yulj
啇	yumd
適	yump
敵	yumt
歒	yumw
甋	yumy
諩	yuog
譜	yuoj
㿶	yupb
䒍	yupc
㡣	yupd
䫕	yupm
鶙	yupo
遆	yupp
覫	yupq
㛳	yupv
讇	yuqe
諮	yuqk
詨	yury
譐	yusf
斕	yusl
讕	yusl
諺	yute
謙	yuvw
謚	yuwl
郎	yv
郎	yvb
郎	yvbh
郎	yvbh
郞	yvbh
詉	yvcy
塱	yvef
㮾	yves
勆	yvet
旔	yvgp
剆	yvjh
䜈	yvjs
郒	yvkc
詔	yvkg
訅	yvn
誛	yvpc
欴	yvqw
㓪	yvvt
詪	yvy
譅	yvyh
䜀	yvyh
䜧	yvyh
認	yvyn
訒	yvyy
訙	yvyy
讱	yvyy
邟	ywbh
訟	ywcy
設	ywcy
頏	ywdm
劥	ywet
診	ywet
裦	yqge
褎	yqge
褏	yqge
襃	yqge
㫅	ywfj
詂	ywfy
論	ywga
讑	ywga
詮	ywgg
諭	ywgj
譮	ywgj
詥	ywgk
諡	ywgl
䚷	ywgn
證	ywgu
譣	ywgw
㼚	ywgy
㫆	ywiy
亱	ywjg
斺	ywjh
䚸	ywjh
䛇	ywkg
說	ywkq
詤	ywnk
迒	ywpv
䲳	ywqo
㰠	ywqw
䛙	ywsy
䛘	ywtf
諷	ywtj
㖱	ywtk
鵺	ywto
㫈	ywuk
乻	ywun
㫇	ywun
旕	ywux
訜	ywvt
㲞	ywwe
讖	ywwg
䛦	ywwk
顇	ywwm
㰵	ywww
雜	ywwy
訛	ywxn
㫃	ywy
詅	ywyc
謢	ywyc
﨎	ywyc
䜃	ywyf
誰	ywyg
誝	ywyk
謒	ywyk
訡	ywyn
諗	ywyn
譙	ywyo
訉	ywyy
詏	yxet
䛹	yxey
譝	yxg
訠	yxhh
䢦	yxip
玅	yxit
詣	yxjg
䛍	yxjh
鄐	yxlb
謴	yxmy
䚰	yxn
牽	yxpg
䲻	yxqo
罋	yxtb
玈	yxte
譺	yxth
䗸	yxtj
㽫	yxtl
甕	yxty
㻾	yxty
孿	yxxb
㝈	yxxb
奱	yxxd
卛	yxxf
㪻	yxxf
矕	yxxh
㡩	yxxh
灓	yxxi
曫	yxxj
蠻	yxxj
㘘	yxxk
巒	yxxm
戀	yxxn
䚹	yxxn
䜝	yxxn
鸞	yxxo
鑾	yxxq
攣	yxxr
諧	yxxr
欒	yxxs
變	yxxt
孌	yxxv
臠	yxxw
譏	yxxw
㱍	yxxw
彎	yxxx
龻	yxxy
㽋	yxxy
䜌	yxxy
孶	yxyb
玆	yxyx
誸	yxyx
諄	yybg
譈	yybt
旈	yyck
堃	yyff
誩	yyg
吂	yygg
訁	yygg
註	yygg
諒	yyiy
䜞	yyjg
讓	yyke
譠	yylg
謞	yymk
䝺	yymu
斒	yyna
諞	yyna
詠	yyni
謆	yynn
該	yynw
譹	yype
諪	yyps
謧	yyrc
訪	yyt
詶	yyth
謫	yyud
諦	yyuh
旘	yyuj
識	yyuj
謪	yyuk
讁	yyup
謗	yyuy
斏	yyvy
誏	yyvy
誶	yywf
詃	yyxy
譶	yyyf
龰	hhgy
〇	llll
